Country,Country Code,Gold,Silver,Bronze,Total,Year,Host_City,Host_Country, GDP (USD Millions) 
Netherlands,NLD,2,4,4,10,1964,Tokyo,JPN," $18,699,380,731.00 "
Bulgaria,BGR,3,5,2,10,1964,Tokyo,JPN, $-   
Pakistan,PAK,0,1,0,1,1964,Tokyo,JPN," $5,204,955,901.00 "
Brazil,BRA,0,0,1,1,1964,Tokyo,JPN," $21,211,892,260.00 "
Italy,ITA,10,10,7,27,1964,Tokyo,JPN," $63,175,417,019.00 "
Sweden,SWE,2,2,4,8,1964,Tokyo,JPN," $22,532,416,750.00 "
Uruguay,URY,0,0,1,1,1964,Tokyo,JPN," $1,975,701,816.00 "
Ireland,IRL,0,0,1,1,1964,Tokyo,JPN," $2,766,608,946.00 "
Japan,JPN,16,5,8,29,1964,Tokyo,JPN," $81,749,006,382.00 "
Iran,IRN,0,0,2,2,1964,Tokyo,JPN," $5,379,845,648.00 "
Cuba,CUB,0,1,0,1,1964,Tokyo,JPN, $-   
Switzerland,CHE,1,2,1,4,1964,Tokyo,JPN," $14,480,556,572.00 "
India,IND,1,0,0,1,1964,Tokyo,JPN," $56,480,289,941.00 "
Kenya,KEN,0,0,1,1,1964,Tokyo,JPN," $998,759,333.60 "
Philippines,PHL,0,1,0,1,1964,Tokyo,JPN," $5,271,404,668.00 "
Hungary,HUN,10,7,5,22,1964,Tokyo,JPN, $-   
United States,USA,36,26,28,90,1964,Tokyo,JPN," $685,800,000,000.00 "
Romania,ROU,2,4,6,12,1964,Tokyo,JPN, $-   
Yugoslavia,YUG,2,1,2,5,1964,Tokyo,JPN,
Ghana,GHA,0,0,1,1,1964,Tokyo,JPN," $1,731,296,119.00 "
Argentina,ARG,0,1,0,1,1964,Tokyo,JPN," $25,605,249,382.00 "
New Zealand,NZL,3,0,2,5,1964,Tokyo,JPN," $7,274,144,351.00 "
Czech Republic,CZE,5,6,3,14,1964,Tokyo,JPN, $-   
Australia,AUS,6,2,10,18,1964,Tokyo,JPN," $23,764,139,321.00 "
Russia,RUS,30,31,35,96,1964,Tokyo,JPN, $-   
Germany,DEU,10,22,18,50,1964,Tokyo,JPN, $-   
Poland,POL,7,6,10,23,1964,Tokyo,JPN, $-   
South Korea,KOR,0,2,1,3,1964,Tokyo,JPN," $3,458,939,358.00 "
France,FRA,1,8,6,15,1964,Tokyo,JPN," $94,007,851,047.00 "
Mexico,MEX,0,0,1,1,1964,Tokyo,JPN," $20,080,000,000.00 "
Finland,FIN,3,0,2,5,1964,Tokyo,JPN," $7,766,655,086.00 "
Canada,CAN,1,2,1,4,1964,Tokyo,JPN," $49,377,522,897.00 "
Trinidad and Tobago,TTO,0,1,2,3,1964,Tokyo,JPN," $711,893,367.60 "
United Kingdom,GBR,4,12,2,18,1964,Tokyo,JPN," $94,407,558,351.00 "
Nigeria,NGA,0,0,1,1,1964,Tokyo,JPN," $5,552,822,484.00 "
Turkey,TUR,2,3,1,6,1964,Tokyo,JPN," $11,177,777,778.00 "
Tunisia,TUN,0,1,1,2,1964,Tokyo,JPN, $-   
Denmark,DNK,2,1,3,6,1964,Tokyo,JPN, $-   
Ethiopia,ETH,1,0,0,1,1964,Tokyo,JPN, $-   
Belgium,BEL,2,0,1,3,1964,Tokyo,JPN," $15,960,106,681.00 "
Bahamas,BHS,1,0,0,1,1964,Tokyo,JPN," $266,666,666.70 "
Czech Republic,CZE,7,2,4,13,1968,Mexico City,MEX, $-   
France,FRA,7,3,5,15,1968,Mexico City,MEX," $129,785,000,000.00 "
Mexico,MEX,3,3,3,9,1968,Mexico City,MEX," $29,360,000,000.00 "
Finland,FIN,1,2,1,4,1968,Mexico City,MEX," $8,823,033,880.00 "
Mongolia,MNG,0,1,3,4,1968,Mexico City,MEX, $-   
Tunisia,TUN,1,0,1,2,1968,Mexico City,MEX," $1,214,666,667.00 "
Turkey,TUR,2,0,0,2,1968,Mexico City,MEX," $17,500,000,000.00 "
Denmark,DNK,1,4,3,8,1968,Mexico City,MEX," $13,505,573,867.00 "
Netherlands,NLD,3,3,1,7,1968,Mexico City,MEX," $27,817,605,743.00 "
Germany,DEU,9,9,7,25,1968,Mexico City,MEX, $-   
Poland,POL,5,2,11,18,1968,Mexico City,MEX, $-   
Romania,ROU,4,6,5,15,1968,Mexico City,MEX, $-   
Venezuela,VEN,1,0,0,1,1968,Mexico City,MEX," $10,034,444,444.00 "
Argentina,ARG,0,0,2,2,1968,Mexico City,MEX," $26,436,857,247.00 "
Russia,RUS,29,32,30,91,1968,Mexico City,MEX, $-   
Belgium,BEL,0,1,1,2,1968,Mexico City,MEX," $21,376,353,113.00 "
Australia,AUS,5,7,5,17,1968,Mexico City,MEX," $32,665,472,057.00 "
Austria,AUT,0,2,2,4,1968,Mexico City,MEX," $12,440,625,313.00 "
Yugoslavia,YUG,3,3,2,8,1968,Mexico City,MEX,
South Korea,KOR,0,1,1,2,1968,Mexico City,MEX," $6,119,284,294.00 "
Pakistan,PAK,1,0,0,1,1968,Mexico City,MEX," $8,041,999,160.00 "
Germany,DEU,5,11,10,26,1968,Mexico City,MEX, $-   
Sweden,SWE,2,1,1,4,1968,Mexico City,MEX," $31,066,819,929.00 "
Greece,GRC,0,0,1,1,1968,Mexico City,MEX," $10,090,675,903.00 "
Cuba,CUB,0,4,0,4,1968,Mexico City,MEX, $-   
United Kingdom,GBR,5,5,3,13,1968,Mexico City,MEX," $107,760,000,000.00 "
Cameroon,CMR,0,1,0,1,1968,Mexico City,MEX," $1,046,191,192.00 "
Bulgaria,BGR,2,4,3,9,1968,Mexico City,MEX, $-   
Brazil,BRA,0,1,2,3,1968,Mexico City,MEX," $33,875,881,876.00 "
United States,USA,45,28,34,107,1968,Mexico City,MEX," $942,500,000,000.00 "
New Zealand,NZL,1,0,2,3,1968,Mexico City,MEX," $5,180,597,621.00 "
Canada,CAN,1,3,1,5,1968,Mexico City,MEX," $71,829,810,520.00 "
Norway,NOR,1,1,0,2,1968,Mexico City,MEX," $10,159,934,137.00 "
Ethiopia,ETH,1,1,0,2,1968,Mexico City,MEX, $-   
Chinese Taipei,TPE,0,0,1,1,1968,Mexico City,MEX,
Jamaica,JAM,0,1,0,1,1968,Mexico City,MEX," $1,083,883,355.00 "
Italy,ITA,3,4,9,16,1968,Mexico City,MEX," $87,942,231,678.00 "
Japan,JPN,11,7,7,25,1968,Mexico City,MEX," $146,601,000,000.00 "
Iran,IRN,2,1,2,5,1968,Mexico City,MEX," $8,623,172,960.00 "
Switzerland,CHE,0,1,4,5,1968,Mexico City,MEX," $18,942,729,779.00 "
India,IND,0,0,1,1,1968,Mexico City,MEX," $53,085,455,871.00 "
Hungary,HUN,10,10,12,32,1968,Mexico City,MEX, $-   
Uganda,UGA,0,1,1,2,1968,Mexico City,MEX," $1,037,815,126.00 "
Kenya,KEN,3,4,2,9,1968,Mexico City,MEX," $1,353,295,458.00 "
Pakistan,PAK,0,1,0,1,1972,Munich,DEU," $9,415,016,360.00 "
Germany,DEU,20,23,23,66,1972,Munich,DEU," $299,802,000,000.00 "
Uganda,UGA,1,1,0,2,1972,Munich,DEU," $1,491,596,639.00 "
Norway,NOR,2,1,1,4,1972,Munich,DEU," $17,358,610,850.00 "
Turkey,TUR,0,1,0,1,1972,Munich,DEU," $20,431,095,406.00 "
Yugoslavia,YUG,2,1,2,5,1972,Munich,DEU,
Niger,NER,0,0,1,1,1972,Munich,DEU," $742,779,740.40 "
United States,USA,33,31,30,94,1972,Munich,DEU," $1,279,110,000,000.00 "
Ghana,GHA,0,0,1,1,1972,Munich,DEU," $2,112,292,945.00 "
Denmark,DNK,1,0,0,1,1972,Munich,DEU," $23,232,379,952.00 "
Jamaica,JAM,0,0,1,1,1972,Munich,DEU," $1,875,048,860.00 "
France,FRA,2,4,7,13,1972,Munich,DEU," $203,494,000,000.00 "
Romania,ROU,3,6,7,16,1972,Munich,DEU, $-   
Finland,FIN,3,1,4,8,1972,Munich,DEU," $14,743,186,120.00 "
Mexico,MEX,0,1,0,1,1972,Munich,DEU," $45,200,000,000.00 "
Sweden,SWE,4,6,6,16,1972,Munich,DEU," $48,954,145,809.00 "
Brazil,BRA,0,0,2,2,1972,Munich,DEU," $58,539,008,786.00 "
Russia,RUS,50,27,22,99,1972,Munich,DEU, $-   
Italy,ITA,5,3,10,18,1972,Munich,DEU," $145,260,000,000.00 "
South Korea,KOR,0,1,0,1,1972,Munich,DEU," $10,862,327,878.00 "
Australia,AUS,8,7,2,17,1972,Munich,DEU," $51,967,289,720.00 "
Greece,GRC,0,2,0,2,1972,Munich,DEU," $16,885,511,364.00 "
Bulgaria,BGR,6,10,5,21,1972,Munich,DEU, $-   
Switzerland,CHE,0,3,0,3,1972,Munich,DEU, $-   
Canada,CAN,0,2,3,5,1972,Munich,DEU," $113,083,000,000.00 "
India,IND,0,0,1,1,1972,Munich,DEU," $71,463,193,830.00 "
Colombia,COL,0,1,2,3,1972,Munich,DEU," $8,671,358,733.00 "
Belgium,BEL,0,2,0,2,1972,Munich,DEU," $37,209,418,019.00 "
Japan,JPN,13,8,8,29,1972,Munich,DEU," $318,031,000,000.00 "
Mongolia,MNG,0,1,0,1,1972,Munich,DEU, $-   
Lebanon,LBN,0,1,0,1,1972,Munich,DEU, $-   
Iran,IRN,0,2,1,3,1972,Munich,DEU," $17,153,463,263.00 "
North Korea,PRK,1,1,3,5,1972,Munich,DEU, $-   
Ethiopia,ETH,0,0,2,2,1972,Munich,DEU, $-   
Tunisia,TUN,0,1,0,1,1972,Munich,DEU," $2,237,476,420.00 "
Argentina,ARG,0,1,0,1,1972,Munich,DEU," $34,733,000,536.00 "
Poland,POL,7,5,9,21,1972,Munich,DEU, $-   
United Kingdom,GBR,4,5,9,18,1972,Munich,DEU," $169,965,000,000.00 "
Austria,AUT,0,1,2,3,1972,Munich,DEU," $22,059,612,477.00 "
Germany,DEU,13,11,16,40,1972,Munich,DEU," $299,802,000,000.00 "
Spain,ESP,0,0,1,1,1972,Munich,DEU," $59,132,415,221.00 "
Netherlands,NLD,3,1,1,5,1972,Munich,DEU," $54,706,557,264.00 "
Cuba,CUB,3,1,4,8,1972,Munich,DEU," $8,135,150,892.00 "
Czech Republic,CZE,2,4,2,8,1972,Munich,DEU, $-   
Hungary,HUN,6,13,16,35,1972,Munich,DEU, $-   
Kenya,KEN,2,3,4,9,1972,Munich,DEU," $2,107,279,157.00 "
New Zealand,NZL,1,1,1,3,1972,Munich,DEU," $9,567,331,065.00 "
Nigeria,NGA,0,0,1,1,1972,Munich,DEU," $12,274,416,018.00 "
Bulgaria,BGR,6,9,7,22,1976,Montreal,CAN, $-   
Canada,CAN,0,5,6,11,1976,Montreal,CAN," $206,576,000,000.00 "
Romania,ROU,4,9,14,27,1976,Montreal,CAN, $-   
South Korea,KOR,1,1,4,6,1976,Montreal,CAN," $29,902,479,339.00 "
Trinidad and Tobago,TTO,1,0,0,1,1976,Montreal,CAN," $2,500,410,584.00 "
Germany,DEU,10,12,17,39,1976,Montreal,CAN," $519,754,000,000.00 "
Netherlands,NLD,0,2,3,5,1976,Montreal,CAN," $109,169,000,000.00 "
Jamaica,JAM,1,1,0,2,1976,Montreal,CAN," $2,966,010,230.00 "
Thailand,THA,0,0,1,1,1976,Montreal,CAN," $16,985,211,146.00 "
Austria,AUT,0,0,1,1,1976,Montreal,CAN," $42,959,976,222.00 "
Iran,IRN,0,1,1,2,1976,Montreal,CAN," $68,055,295,081.00 "
Mongolia,MNG,0,1,0,1,1976,Montreal,CAN, $-   
United States,USA,34,35,25,94,1976,Montreal,CAN," $1,873,410,000,000.00 "
Finland,FIN,4,2,0,6,1976,Montreal,CAN," $31,849,513,771.00 "
United Kingdom,GBR,3,5,5,13,1976,Montreal,CAN," $232,615,000,000.00 "
Russia,RUS,49,41,35,125,1976,Montreal,CAN, $-   
Japan,JPN,9,6,10,25,1976,Montreal,CAN," $586,162,000,000.00 "
Germany,DEU,40,25,25,90,1976,Montreal,CAN," $519,754,000,000.00 "
North Korea,PRK,1,1,0,2,1976,Montreal,CAN, $-   
Sweden,SWE,4,1,0,5,1976,Montreal,CAN," $89,362,071,673.00 "
New Zealand,NZL,2,1,1,4,1976,Montreal,CAN," $13,604,832,424.00 "
Belgium,BEL,0,3,3,6,1976,Montreal,CAN," $71,113,882,968.00 "
Italy,ITA,2,7,4,13,1976,Montreal,CAN," $224,717,000,000.00 "
Bermuda,BMU,0,0,1,1,1976,Montreal,CAN," $386,300,000.00 "
Denmark,DNK,1,0,2,3,1976,Montreal,CAN," $44,575,892,473.00 "
Puerto Rico,PRI,0,0,1,1,1976,Montreal,CAN," $8,968,600,000.00 "
Brazil,BRA,0,0,2,2,1976,Montreal,CAN," $152,678,000,000.00 "
Pakistan,PAK,0,0,1,1,1976,Montreal,CAN," $13,168,080,808.00 "
Venezuela,VEN,0,1,0,1,1976,Montreal,CAN," $31,419,534,884.00 "
Poland,POL,7,6,13,26,1976,Montreal,CAN, $-   
Yugoslavia,YUG,2,3,3,8,1976,Montreal,CAN,
Mexico,MEX,1,0,1,2,1976,Montreal,CAN," $89,025,974,026.00 "
Australia,AUS,0,1,4,5,1976,Montreal,CAN," $104,921,000,000.00 "
Hungary,HUN,4,5,13,22,1976,Montreal,CAN, $-   
Czech Republic,CZE,2,2,4,8,1976,Montreal,CAN, $-   
Portugal,PRT,0,2,0,2,1976,Montreal,CAN," $20,332,831,565.00 "
France,FRA,2,3,4,9,1976,Montreal,CAN," $372,319,000,000.00 "
Cuba,CUB,6,4,3,13,1976,Montreal,CAN," $13,789,579,903.00 "
Spain,ESP,0,2,0,2,1976,Montreal,CAN," $118,507,000,000.00 "
Norway,NOR,1,1,0,2,1976,Montreal,CAN," $35,942,270,686.00 "
Switzerland,CHE,1,1,2,4,1976,Montreal,CAN, $-   
Venezuela,VEN,0,1,0,1,1980,Moscow,RUS," $59,116,511,628.00 "
Jamaica,JAM,0,0,3,3,1980,Moscow,RUS," $2,679,409,453.00 "
Bulgaria,BGR,8,16,17,41,1980,Moscow,RUS," $19,839,230,769.00 "
Russia,RUS,80,69,46,195,1980,Moscow,RUS, $-   
India,IND,1,0,0,1,1980,Moscow,RUS," $186,325,000,000.00 "
Brazil,BRA,2,0,2,4,1980,Moscow,RUS," $235,025,000,000.00 "
Italy,ITA,8,3,4,15,1980,Moscow,RUS," $477,257,000,000.00 "
Spain,ESP,1,3,2,6,1980,Moscow,RUS," $232,767,000,000.00 "
Netherlands,NLD,0,1,2,3,1980,Moscow,RUS," $195,152,000,000.00 "
Uganda,UGA,0,1,0,1,1980,Moscow,RUS," $1,244,610,000.00 "
Belgium,BEL,1,0,0,1,1980,Moscow,RUS," $126,829,000,000.00 "
Cuba,CUB,8,7,5,20,1980,Moscow,RUS," $19,912,889,861.00 "
Switzerland,CHE,2,0,0,2,1980,Moscow,RUS," $122,661,000,000.00 "
Poland,POL,3,14,15,32,1980,Moscow,RUS, $-   
Sweden,SWE,3,3,6,12,1980,Moscow,RUS," $142,092,000,000.00 "
Romania,ROU,6,6,13,25,1980,Moscow,RUS, $-   
Ireland,IRL,0,1,1,2,1980,Moscow,RUS," $21,751,265,577.00 "
Zimbabwe,ZWE,1,0,0,1,1980,Moscow,RUS," $6,678,868,200.00 "
United Kingdom,GBR,5,7,9,21,1980,Moscow,RUS," $564,948,000,000.00 "
Tanzania,TZA,0,2,0,2,1980,Moscow,RUS, $-   
France,FRA,6,5,3,14,1980,Moscow,RUS," $701,288,000,000.00 "
Mexico,MEX,0,1,3,4,1980,Moscow,RUS," $205,139,000,000.00 "
Hungary,HUN,7,10,15,32,1980,Moscow,RUS, $-   
Germany,DEU,47,37,42,126,1980,Moscow,RUS," $950,291,000,000.00 "
Ethiopia,ETH,2,0,2,4,1980,Moscow,RUS, $-   
Czech Republic,CZE,2,3,9,14,1980,Moscow,RUS, $-   
Finland,FIN,3,1,4,8,1980,Moscow,RUS," $53,645,202,423.00 "
North Korea,PRK,0,3,2,5,1980,Moscow,RUS, $-   
Greece,GRC,1,0,2,3,1980,Moscow,RUS," $56,829,664,269.00 "
Yugoslavia,YUG,2,3,4,9,1980,Moscow,RUS,
Denmark,DNK,2,1,2,5,1980,Moscow,RUS," $71,127,528,700.00 "
Mongolia,MNG,0,2,2,4,1980,Moscow,RUS, $-   
Guyana,GUY,0,0,1,1,1980,Moscow,RUS," $603,200,000.00 "
Austria,AUT,1,2,1,4,1980,Moscow,RUS," $82,058,912,997.00 "
Australia,AUS,2,2,5,9,1980,Moscow,RUS," $149,776,000,000.00 "
Lebanon,LBN,0,0,1,1,1980,Moscow,RUS, $-   
Kenya,KEN,1,0,2,3,1984,Los Angeles,USA," $6,191,437,070.00 "
Morocco,MAR,2,0,0,2,1984,Los Angeles,USA," $14,824,728,528.00 "
Dominican Republic,DOM,0,0,1,1,1984,Los Angeles,USA," $11,594,000,000.00 "
Turkey,TUR,0,0,3,3,1984,Los Angeles,USA," $59,989,909,458.00 "
Syria,SYR,0,1,0,1,1984,Los Angeles,USA," $17,503,082,982.00 "
Colombia,COL,0,1,0,1,1984,Los Angeles,USA," $38,253,120,738.00 "
China,CHN,15,8,9,32,1984,Los Angeles,USA," $259,947,000,000.00 "
Yugoslavia,YUG,7,4,7,18,1984,Los Angeles,USA,
Puerto Rico,PRI,0,1,1,2,1984,Los Angeles,USA," $19,162,600,000.00 "
Romania,ROU,20,16,17,53,1984,Los Angeles,USA, $-   
Netherlands,NLD,5,2,6,13,1984,Los Angeles,USA," $143,913,000,000.00 "
Chinese Taipei,TPE,0,0,1,1,1984,Los Angeles,USA,
Japan,JPN,10,8,14,32,1984,Los Angeles,USA," $1,318,380,000,000.00 "
Switzerland,CHE,0,4,4,8,1984,Los Angeles,USA," $109,547,000,000.00 "
Egypt,EGY,0,1,0,1,1984,Los Angeles,USA," $33,971,188,992.00 "
South Korea,KOR,6,6,7,19,1984,Los Angeles,USA," $97,510,235,986.00 "
Venezuela,VEN,0,0,3,3,1984,Los Angeles,USA," $60,010,285,714.00 "
Nigeria,NGA,0,1,1,2,1984,Los Angeles,USA," $73,484,359,521.00 "
Denmark,DNK,0,3,3,6,1984,Los Angeles,USA," $59,105,236,854.00 "
Austria,AUT,1,1,1,3,1984,Los Angeles,USA," $67,985,344,887.00 "
Spain,ESP,1,2,2,5,1984,Los Angeles,USA," $172,103,000,000.00 "
Portugal,PRT,1,0,2,3,1984,Los Angeles,USA," $25,217,969,050.00 "
Greece,GRC,0,1,1,2,1984,Los Angeles,USA," $48,020,024,184.00 "
New Zealand,NZL,8,1,2,11,1984,Los Angeles,USA," $21,665,975,319.00 "
Brazil,BRA,1,5,2,8,1984,Los Angeles,USA," $209,024,000,000.00 "
Iceland,ISL,0,0,1,1,1984,Los Angeles,USA," $2,864,441,356.00 "
Zambia,ZMB,0,0,1,1,1984,Los Angeles,USA," $2,739,444,444.00 "
Canada,CAN,10,18,16,44,1984,Los Angeles,USA," $355,373,000,000.00 "
Sweden,SWE,2,11,6,19,1984,Los Angeles,USA," $109,201,000,000.00 "
Germany,DEU,17,19,23,59,1984,Los Angeles,USA," $725,111,000,000.00 "
Ireland,IRL,0,1,0,1,1984,Los Angeles,USA," $20,109,800,239.00 "
Cameroon,CMR,0,0,1,1,1984,Los Angeles,USA," $7,311,937,457.00 "
Norway,NOR,0,1,2,3,1984,Los Angeles,USA," $62,057,955,033.00 "
Belgium,BEL,1,1,2,4,1984,Los Angeles,USA," $83,349,530,159.00 "
Pakistan,PAK,1,0,0,1,1984,Los Angeles,USA," $31,151,825,467.00 "
Ivory Coast,CIV,0,1,0,1,1984,Los Angeles,USA," $6,841,638,715.00 "
France,FRA,5,7,16,28,1984,Los Angeles,USA," $530,684,000,000.00 "
Peru,PER,0,1,0,1,1984,Los Angeles,USA," $17,599,660,054.00 "
Algeria,DZA,0,0,2,2,1984,Los Angeles,USA," $53,698,278,906.00 "
Italy,ITA,14,6,12,32,1984,Los Angeles,USA," $437,888,000,000.00 "
Australia,AUS,4,8,12,24,1984,Los Angeles,USA," $193,242,000,000.00 "
Mexico,MEX,2,3,1,6,1984,Los Angeles,USA," $184,261,000,000.00 "
Jamaica,JAM,0,1,2,3,1984,Los Angeles,USA," $2,373,566,957.00 "
United Kingdom,GBR,5,11,21,37,1984,Los Angeles,USA," $461,487,000,000.00 "
Finland,FIN,4,2,6,12,1984,Los Angeles,USA," $52,888,800,950.00 "
United States,USA,83,61,30,174,1984,Los Angeles,USA," $4,037,610,000,000.00 "
Thailand,THA,0,1,0,1,1984,Los Angeles,USA," $41,797,592,963.00 "
Mongolia,MNG,0,0,1,1,1988,Seoul,KOR," $3,204,461,567.00 "
Senegal,SEN,0,1,0,1,1988,Seoul,KOR," $6,418,419,798.00 "
Czech Republic,CZE,3,3,2,8,1988,Seoul,KOR, $-   
U.S. Virgin Islands,VIR,0,1,0,1,1988,Seoul,KOR, $-   
Colombia,COL,0,0,1,1,1988,Seoul,KOR," $39,212,550,050.00 "
New Zealand,NZL,3,2,8,13,1988,Seoul,KOR," $45,176,811,594.00 "
Poland,POL,2,5,9,16,1988,Seoul,KOR, $-   
Netherlands,NLD,2,2,5,9,1988,Seoul,KOR," $261,911,000,000.00 "
Costa Rica,CRI,0,1,0,1,1988,Seoul,KOR," $4,614,629,898.00 "
Philippines,PHL,0,0,1,1,1988,Seoul,KOR," $37,885,440,419.00 "
Turkey,TUR,1,1,0,2,1988,Seoul,KOR," $90,852,814,005.00 "
France,FRA,6,4,6,16,1988,Seoul,KOR," $1,018,850,000,000.00 "
Norway,NOR,2,3,0,5,1988,Seoul,KOR," $101,900,000,000.00 "
Finland,FIN,1,1,2,4,1988,Seoul,KOR," $109,059,000,000.00 "
Romania,ROU,7,11,6,24,1988,Seoul,KOR," $40,809,523,810.00 "
Brazil,BRA,1,2,3,6,1988,Seoul,KOR," $330,397,000,000.00 "
Belgium,BEL,0,0,2,2,1988,Seoul,KOR," $162,299,000,000.00 "
Mexico,MEX,0,0,2,2,1988,Seoul,KOR," $181,612,000,000.00 "
Peru,PER,0,1,0,1,1988,Seoul,KOR," $15,439,408,447.00 "
Australia,AUS,3,6,5,14,1988,Seoul,KOR," $235,658,000,000.00 "
Bulgaria,BGR,10,12,13,35,1988,Seoul,KOR," $22,555,941,176.00 "
Pakistan,PAK,0,0,1,1,1988,Seoul,KOR," $38,472,742,808.00 "
Austria,AUT,1,0,0,1,1988,Seoul,KOR," $133,339,000,000.00 "
Netherlands Antilles,ANT,0,1,0,1,1988,Seoul,KOR,
Denmark,DNK,2,1,1,4,1988,Seoul,KOR," $115,553,000,000.00 "
United States,USA,36,31,27,94,1988,Seoul,KOR," $5,236,440,000,000.00 "
Chile,CHL,0,1,0,1,1988,Seoul,KOR," $26,040,229,793.00 "
China,CHN,5,11,12,28,1988,Seoul,KOR," $312,354,000,000.00 "
Thailand,THA,0,0,1,1,1988,Seoul,KOR," $61,667,199,835.00 "
Switzerland,CHE,0,2,2,4,1988,Seoul,KOR," $215,722,000,000.00 "
Italy,ITA,6,4,4,14,1988,Seoul,KOR," $891,609,000,000.00 "
Germany,DEU,11,14,15,40,1988,Seoul,KOR," $1,401,230,000,000.00 "
Spain,ESP,1,1,2,4,1988,Seoul,KOR," $376,160,000,000.00 "
Greece,GRC,0,0,1,1,1988,Seoul,KOR," $76,261,277,925.00 "
Argentina,ARG,0,1,1,2,1988,Seoul,KOR," $126,207,000,000.00 "
Indonesia,IDN,0,1,0,1,1988,Seoul,KOR," $84,300,174,477.00 "
Jamaica,JAM,0,2,0,2,1988,Seoul,KOR," $3,828,310,735.00 "
Japan,JPN,4,3,7,14,1988,Seoul,KOR," $3,071,680,000,000.00 "
Germany,DEU,37,35,30,102,1988,Seoul,KOR," $1,401,230,000,000.00 "
South Korea,KOR,12,10,11,33,1988,Seoul,KOR," $199,591,000,000.00 "
Yugoslavia,YUG,3,4,5,12,1988,Seoul,KOR,
United Kingdom,GBR,5,10,9,24,1988,Seoul,KOR," $910,123,000,000.00 "
Sweden,SWE,0,4,7,11,1988,Seoul,KOR," $206,987,000,000.00 "
Morocco,MAR,1,0,2,3,1988,Seoul,KOR," $25,705,296,184.00 "
Canada,CAN,3,2,5,10,1988,Seoul,KOR," $507,354,000,000.00 "
Russia,RUS,55,31,46,132,1988,Seoul,KOR," $554,713,000,000.00 "
Djibouti,DJI,0,0,1,1,1988,Seoul,KOR," $395,794,538.60 "
Portugal,PRT,1,0,0,1,1988,Seoul,KOR," $56,347,250,696.00 "
Hungary,HUN,11,6,6,23,1988,Seoul,KOR, $-   
Kenya,KEN,5,2,2,9,1988,Seoul,KOR," $8,355,380,879.00 "
Iran,IRN,0,1,0,1,1988,Seoul,KOR," $123,058,000,000.00 "
Suriname,SUR,1,0,0,1,1988,Seoul,KOR," $1,161,000,000.00 "
Romania,ROU,4,6,8,18,1992,Barcelona,ESP," $25,121,666,667.00 "
South Korea,KOR,12,5,12,29,1992,Barcelona,ESP," $355,525,000,000.00 "
Mexico,MEX,0,1,0,1,1992,Barcelona,ESP," $363,158,000,000.00 "
South Africa,ZAF,0,2,0,2,1992,Barcelona,ESP," $134,545,000,000.00 "
Estonia,EST,1,0,1,2,1992,Barcelona,ESP, $-   
Germany,DEU,33,21,28,82,1992,Barcelona,ESP," $2,131,570,000,000.00 "
Greece,GRC,2,0,0,2,1992,Barcelona,ESP," $116,225,000,000.00 "
Latvia,LVA,0,2,1,3,1992,Barcelona,ESP, $-   
Ghana,GHA,0,0,1,1,1992,Barcelona,ESP," $6,413,901,602.00 "
Morocco,MAR,1,1,1,3,1992,Barcelona,ESP," $33,711,069,431.00 "
Denmark,DNK,1,1,4,6,1992,Barcelona,ESP," $152,916,000,000.00 "
Finland,FIN,1,2,2,5,1992,Barcelona,ESP," $112,533,000,000.00 "
Mongolia,MNG,0,0,2,2,1992,Barcelona,ESP," $1,317,611,864.00 "
Australia,AUS,7,9,11,27,1992,Barcelona,ESP," $324,884,000,000.00 "
Suriname,SUR,0,0,1,1,1992,Barcelona,ESP," $404,600,000.00 "
Thailand,THA,0,0,1,1,1992,Barcelona,ESP," $111,453,000,000.00 "
France,FRA,8,5,16,29,1992,Barcelona,ESP," $1,401,470,000,000.00 "
Ethiopia,ETH,1,0,2,3,1992,Barcelona,ESP," $10,492,993,078.00 "
Puerto Rico,PRI,0,0,1,1,1992,Barcelona,ESP," $34,630,430,000.00 "
Netherlands,NLD,2,6,7,15,1992,Barcelona,ESP," $362,963,000,000.00 "
Hungary,HUN,11,12,7,30,1992,Barcelona,ESP," $38,730,585,922.00 "
Switzerland,CHE,1,0,0,1,1992,Barcelona,ESP," $280,157,000,000.00 "
Kenya,KEN,2,4,2,8,1992,Barcelona,ESP," $8,209,129,172.00 "
Austria,AUT,0,2,0,2,1992,Barcelona,ESP," $195,078,000,000.00 "
Cuba,CUB,14,6,11,31,1992,Barcelona,ESP," $22,085,858,243.00 "
Turkey,TUR,2,2,2,6,1992,Barcelona,ESP," $158,459,000,000.00 "
Poland,POL,3,6,10,19,1992,Barcelona,ESP," $94,337,050,693.00 "
Czech Republic,CZE,4,2,1,7,1992,Barcelona,ESP," $34,805,013,230.00 "
Namibia,NAM,0,2,0,2,1992,Barcelona,ESP," $3,429,538,518.00 "
Lithuania,LTU,1,0,1,2,1992,Barcelona,ESP, $-   
Malaysia,MYS,0,0,1,1,1992,Barcelona,ESP," $59,167,550,163.00 "
Slovenia,SVN,0,0,2,2,1992,Barcelona,ESP, $-   
Croatia,HRV,0,1,2,3,1992,Barcelona,ESP, $-   
China,CHN,16,22,16,54,1992,Barcelona,ESP," $426,916,000,000.00 "
United States,USA,37,34,37,108,1992,Barcelona,ESP," $6,520,330,000,000.00 "
Spain,ESP,13,7,2,22,1992,Barcelona,ESP," $630,916,000,000.00 "
Japan,JPN,3,8,11,22,1992,Barcelona,ESP," $3,908,810,000,000.00 "
Colombia,COL,0,0,1,1,1992,Barcelona,ESP," $58,418,985,443.00 "
Unified Team,EUN,45,38,29,112,1992,Barcelona,ESP,
Argentina,ARG,0,0,1,1,1992,Barcelona,ESP," $228,789,000,000.00 "
New Zealand,NZL,1,4,5,10,1992,Barcelona,ESP," $41,649,829,860.00 "
Indonesia,IDN,2,2,1,5,1992,Barcelona,ESP," $128,027,000,000.00 "
Belgium,BEL,0,1,2,3,1992,Barcelona,ESP," $234,782,000,000.00 "
Italy,ITA,6,5,8,19,1992,Barcelona,ESP," $1,320,160,000,000.00 "
Chinese Taipei,TPE,0,1,0,1,1992,Barcelona,ESP,
Israel,ISR,0,1,1,2,1992,Barcelona,ESP, $-   
Pakistan,PAK,0,0,1,1,1992,Barcelona,ESP," $48,884,606,848.00 "
Peru,PER,0,1,0,1,1992,Barcelona,ESP," $35,966,302,303.00 "
Individual Olympic Athletes,IOA,0,1,2,3,1992,Barcelona,ESP,
Bulgaria,BGR,3,7,6,16,1992,Barcelona,ESP," $10,350,515,464.00 "
Nigeria,NGA,0,3,1,4,1992,Barcelona,ESP," $47,794,925,815.00 "
Norway,NOR,2,4,1,7,1992,Barcelona,ESP," $130,838,000,000.00 "
Brazil,BRA,2,1,0,3,1992,Barcelona,ESP," $400,599,000,000.00 "
United Kingdom,GBR,5,3,12,20,1992,Barcelona,ESP," $1,179,660,000,000.00 "
North Korea,PRK,4,0,5,9,1992,Barcelona,ESP, $-   
Canada,CAN,7,4,7,18,1992,Barcelona,ESP," $592,388,000,000.00 "
Sweden,SWE,1,7,4,12,1992,Barcelona,ESP," $284,321,000,000.00 "
Iran,IRN,0,1,2,3,1992,Barcelona,ESP, $-   
Algeria,DZA,1,0,1,2,1992,Barcelona,ESP," $48,003,078,389.00 "
Bahamas,BHS,0,0,1,1,1992,Barcelona,ESP," $3,109,000,000.00 "
Qatar,QAT,0,0,1,1,1992,Barcelona,ESP," $7,646,153,984.00 "
Ireland,IRL,1,1,0,2,1992,Barcelona,ESP," $55,927,302,693.00 "
Jamaica,JAM,0,3,1,4,1992,Barcelona,ESP," $3,535,460,090.00 "
Philippines,PHL,0,0,1,1,1992,Barcelona,ESP," $52,976,344,929.00 "
Azerbaijan,AZE,0,1,0,1,1996,Atlanta,USA," $3,176,333,837.00 "
Australia,AUS,9,9,23,41,1996,Atlanta,USA," $400,303,000,000.00 "
India,IND,0,0,1,1,1996,Atlanta,USA," $392,897,000,000.00 "
Germany,DEU,20,18,27,65,1996,Atlanta,USA," $2,497,240,000,000.00 "
Turkey,TUR,4,1,1,6,1996,Atlanta,USA," $181,476,000,000.00 "
Greece,GRC,4,4,0,8,1996,Atlanta,USA," $145,862,000,000.00 "
Denmark,DNK,4,1,1,6,1996,Atlanta,USA," $187,632,000,000.00 "
Brazil,BRA,3,3,9,15,1996,Atlanta,USA," $850,426,000,000.00 "
Burundi,BDI,1,0,0,1,1996,Atlanta,USA," $869,033,856.30 "
Syria,SYR,1,0,0,1,1996,Atlanta,USA," $13,789,560,878.00 "
Georgia,GEO,0,0,2,2,1996,Atlanta,USA," $3,095,047,604.00 "
United States,USA,44,32,25,101,1996,Atlanta,USA," $8,073,120,000,000.00 "
Czech Republic,CZE,4,3,4,11,1996,Atlanta,USA," $67,387,788,633.00 "
Ecuador,ECU,1,0,0,1,1996,Atlanta,USA," $25,226,393,197.00 "
Thailand,THA,1,0,1,2,1996,Atlanta,USA," $183,035,000,000.00 "
Argentina,ARG,0,2,1,3,1996,Atlanta,USA," $272,150,000,000.00 "
Bulgaria,BGR,3,7,5,15,1996,Atlanta,USA," $12,294,221,473.00 "
Ireland,IRL,3,0,1,4,1996,Atlanta,USA," $75,786,499,496.00 "
China,CHN,16,22,12,50,1996,Atlanta,USA," $863,747,000,000.00 "
Tonga,TON,0,1,0,1,1996,Atlanta,USA," $222,100,576.30 "
Cuba,CUB,9,8,8,25,1996,Atlanta,USA," $25,017,368,700.00 "
Israel,ISR,0,0,1,1,1996,Atlanta,USA," $110,429,000,000.00 "
Finland,FIN,1,2,1,4,1996,Atlanta,USA," $132,129,000,000.00 "
Armenia,ARM,1,1,0,2,1996,Atlanta,USA," $1,596,968,946.00 "
Indonesia,IDN,1,1,2,4,1996,Atlanta,USA," $227,370,000,000.00 "
Trinidad and Tobago,TTO,0,0,2,2,1996,Atlanta,USA," $5,759,537,726.00 "
France,FRA,15,7,15,37,1996,Atlanta,USA," $1,605,680,000,000.00 "
Italy,ITA,13,10,12,35,1996,Atlanta,USA," $1,312,430,000,000.00 "
Algeria,DZA,2,0,1,3,1996,Atlanta,USA," $46,941,582,519.00 "
Ethiopia,ETH,2,0,1,3,1996,Atlanta,USA," $8,547,939,731.00 "
United Kingdom,GBR,1,8,6,15,1996,Atlanta,USA," $1,415,390,000,000.00 "
Sweden,SWE,2,4,2,8,1996,Atlanta,USA," $291,744,000,000.00 "
Iran,IRN,1,1,1,3,1996,Atlanta,USA," $120,404,000,000.00 "
Chinese Taipei,TPE,0,1,0,1,1996,Atlanta,USA,
Canada,CAN,3,11,8,22,1996,Atlanta,USA," $628,546,000,000.00 "
Costa Rica,CRI,1,0,0,1,1996,Atlanta,USA," $11,678,424,512.00 "
Zambia,ZMB,0,1,0,1,1996,Atlanta,USA," $3,597,220,962.00 "
Uzbekistan,UZB,0,1,1,2,1996,Atlanta,USA," $13,948,892,216.00 "
Uganda,UGA,0,0,1,1,1996,Atlanta,USA," $6,044,585,327.00 "
Belarus,BLR,1,6,8,15,1996,Atlanta,USA," $14,756,846,154.00 "
Hong Kong,HKG,1,0,0,1,1996,Atlanta,USA," $159,717,000,000.00 "
Jamaica,JAM,1,3,2,6,1996,Atlanta,USA," $7,393,883,555.00 "
Slovakia,SVK,1,1,1,3,1996,Atlanta,USA," $27,925,036,755.00 "
Morocco,MAR,0,0,2,2,1996,Atlanta,USA," $43,161,452,678.00 "
Kenya,KEN,1,4,3,8,1996,Atlanta,USA," $12,045,858,436.00 "
Namibia,NAM,0,2,0,2,1996,Atlanta,USA," $3,989,208,671.00 "
Spain,ESP,5,6,6,17,1996,Atlanta,USA," $642,589,000,000.00 "
New Zealand,NZL,3,2,1,6,1996,Atlanta,USA," $70,140,835,299.00 "
Serbia and Montenegro,SCG,1,1,2,4,1996,Atlanta,USA,
Romania,ROU,4,7,9,20,1996,Atlanta,USA," $36,937,074,278.00 "
Malaysia,MYS,0,1,1,2,1996,Atlanta,USA," $100,855,000,000.00 "
Lithuania,LTU,0,0,1,1,1996,Atlanta,USA," $8,382,519,637.00 "
Puerto Rico,PRI,0,0,1,1,1996,Atlanta,USA," $45,340,835,000.00 "
Norway,NOR,2,2,3,7,1996,Atlanta,USA," $163,520,000,000.00 "
Poland,POL,7,5,5,17,1996,Atlanta,USA," $160,193,000,000.00 "
South Korea,KOR,7,15,5,27,1996,Atlanta,USA," $610,170,000,000.00 "
Mexico,MEX,0,0,1,1,1996,Atlanta,USA," $410,976,000,000.00 "
South Africa,ZAF,3,1,1,5,1996,Atlanta,USA," $147,608,000,000.00 "
Mozambique,MOZ,0,0,1,1,1996,Atlanta,USA," $3,856,799,844.00 "
Moldova,MDA,0,1,1,2,1996,Atlanta,USA," $1,695,122,174.00 "
Portugal,PRT,1,0,1,2,1996,Atlanta,USA," $122,630,000,000.00 "
Ukraine,UKR,9,2,12,23,1996,Atlanta,USA," $44,558,076,852.00 "
Hungary,HUN,7,4,10,21,1996,Atlanta,USA," $46,658,755,152.00 "
Tunisia,TUN,0,0,1,1,1996,Atlanta,USA," $19,587,322,786.00 "
Bahamas,BHS,0,1,0,1,1996,Atlanta,USA," $3,609,000,000.00 "
Belgium,BEL,2,2,2,6,1996,Atlanta,USA," $279,201,000,000.00 "
Switzerland,CHE,4,3,0,7,1996,Atlanta,USA," $340,471,000,000.00 "
Austria,AUT,0,1,2,3,1996,Atlanta,USA," $237,251,000,000.00 "
Kazakhstan,KAZ,3,4,4,11,1996,Atlanta,USA," $21,035,368,251.00 "
Croatia,HRV,1,1,0,2,1996,Atlanta,USA," $23,846,613,059.00 "
Japan,JPN,3,6,5,14,1996,Atlanta,USA," $4,833,710,000,000.00 "
Nigeria,NGA,2,1,3,6,1996,Atlanta,USA," $51,075,815,093.00 "
Mongolia,MNG,0,0,1,1,1996,Atlanta,USA," $1,345,719,472.00 "
Philippines,PHL,0,1,0,1,1996,Atlanta,USA," $82,848,140,618.00 "
Slovenia,SVN,0,2,0,2,1996,Atlanta,USA," $21,507,232,649.00 "
Latvia,LVA,0,1,0,1,1996,Atlanta,USA," $5,969,114,344.00 "
Russia,RUS,26,21,16,63,1996,Atlanta,USA," $391,725,000,000.00 "
North Korea,PRK,2,1,2,5,1996,Atlanta,USA, $-   
Netherlands,NLD,4,5,10,19,1996,Atlanta,USA," $450,490,000,000.00 "
Ireland,IRL,0,1,0,1,2000,Sydney,AUS," $99,871,239,174.00 "
Algeria,DZA,1,1,3,5,2000,Sydney,AUS," $54,790,379,459.00 "
Jamaica,JAM,0,6,3,9,2000,Sydney,AUS," $9,005,064,475.00 "
Qatar,QAT,0,0,1,1,2000,Sydney,AUS," $17,759,890,110.00 "
Spain,ESP,3,3,5,11,2000,Sydney,AUS," $596,878,000,000.00 "
Iran,IRN,3,0,1,4,2000,Sydney,AUS," $109,592,000,000.00 "
Sweden,SWE,4,5,3,12,2000,Sydney,AUS," $262,835,000,000.00 "
Hungary,HUN,8,6,3,17,2000,Sydney,AUS," $47,218,405,892.00 "
Indonesia,IDN,1,3,2,6,2000,Sydney,AUS," $165,021,000,000.00 "
Japan,JPN,5,8,5,18,2000,Sydney,AUS," $4,887,520,000,000.00 "
Armenia,ARM,0,0,1,1,2000,Sydney,AUS," $1,911,563,669.00 "
India,IND,0,0,1,1,2000,Sydney,AUS," $468,395,000,000.00 "
Australia,AUS,16,25,17,58,2000,Sydney,AUS," $415,223,000,000.00 "
Kazakhstan,KAZ,3,4,0,7,2000,Sydney,AUS," $18,291,994,909.00 "
Iceland,ISL,0,0,1,1,2000,Sydney,AUS," $9,025,660,362.00 "
Israel,ISR,0,0,1,1,2000,Sydney,AUS," $132,705,000,000.00 "
Argentina,ARG,0,2,2,4,2000,Sydney,AUS," $284,204,000,000.00 "
Italy,ITA,13,8,13,34,2000,Sydney,AUS," $1,143,830,000,000.00 "
France,FRA,13,14,11,38,2000,Sydney,AUS," $1,362,250,000,000.00 "
South Korea,KOR,8,10,10,28,2000,Sydney,AUS," $576,178,000,000.00 "
Portugal,PRT,0,0,2,2,2000,Sydney,AUS," $118,311,000,000.00 "
Latvia,LVA,1,1,1,3,2000,Sydney,AUS," $7,949,253,766.00 "
Poland,POL,6,5,3,14,2000,Sydney,AUS," $172,219,000,000.00 "
Nigeria,NGA,1,2,0,3,2000,Sydney,AUS," $69,448,756,933.00 "
Georgia,GEO,0,0,6,6,2000,Sydney,AUS," $3,057,475,335.00 "
Lithuania,LTU,2,0,3,5,2000,Sydney,AUS," $11,524,776,867.00 "
Azerbaijan,AZE,2,0,1,3,2000,Sydney,AUS," $5,272,798,391.00 "
Thailand,THA,1,0,2,3,2000,Sydney,AUS," $126,392,000,000.00 "
Greece,GRC,4,6,3,13,2000,Sydney,AUS," $130,134,000,000.00 "
Macedonia,MKD,0,0,1,1,2000,Sydney,AUS," $3,773,653,058.00 "
Bahamas,BHS,2,0,1,3,2000,Sydney,AUS," $8,076,470,000.00 "
South Africa,ZAF,0,2,3,5,2000,Sydney,AUS," $136,362,000,000.00 "
Finland,FIN,2,1,1,4,2000,Sydney,AUS," $125,707,000,000.00 "
Trinidad and Tobago,TTO,0,1,1,2,2000,Sydney,AUS," $8,154,338,233.00 "
Kyrgyzstan,KGZ,0,0,1,1,2000,Sydney,AUS," $1,369,688,498.00 "
Romania,ROU,11,6,9,26,2000,Sydney,AUS," $37,253,259,017.00 "
Kuwait,KWT,0,0,1,1,2000,Sydney,AUS," $37,712,842,243.00 "
Sri Lanka,LKA,0,1,0,1,2000,Sydney,AUS," $16,330,814,180.00 "
Switzerland,CHE,1,6,2,9,2000,Sydney,AUS," $279,841,000,000.00 "
Germany,DEU,13,17,26,56,2000,Sydney,AUS," $1,943,150,000,000.00 "
Kenya,KEN,2,3,2,7,2000,Sydney,AUS," $12,705,357,103.00 "
North Korea,PRK,0,1,3,4,2000,Sydney,AUS, $-   
Colombia,COL,1,0,0,1,2000,Sydney,AUS," $99,886,577,331.00 "
New Zealand,NZL,1,0,3,4,2000,Sydney,AUS," $52,623,281,957.00 "
Canada,CAN,3,3,8,14,2000,Sydney,AUS," $744,773,000,000.00 "
Saudi Arabia,SAU,0,1,1,2,2000,Sydney,AUS," $189,515,000,000.00 "
Chinese Taipei,TPE,0,1,4,5,2000,Sydney,AUS,
Chile,CHL,0,0,1,1,2000,Sydney,AUS," $77,860,932,152.00 "
China,CHN,28,16,14,58,2000,Sydney,AUS," $1,211,350,000,000.00 "
Morocco,MAR,0,1,4,5,2000,Sydney,AUS," $38,857,251,336.00 "
Mozambique,MOZ,1,0,0,1,2000,Sydney,AUS," $5,656,473,652.00 "
Estonia,EST,1,0,2,3,2000,Sydney,AUS," $5,694,069,842.00 "
Belarus,BLR,3,3,11,17,2000,Sydney,AUS," $12,738,912,134.00 "
Slovenia,SVN,2,0,0,2,2000,Sydney,AUS," $20,289,627,637.00 "
Moldova,MDA,0,1,1,2,2000,Sydney,AUS," $1,288,429,392.00 "
Belgium,BEL,0,2,3,5,2000,Sydney,AUS," $236,205,000,000.00 "
Vietnam,VNM,0,1,0,1,2000,Sydney,AUS," $31,172,518,403.00 "
Brazil,BRA,0,6,6,12,2000,Sydney,AUS," $655,421,000,000.00 "
Russia,RUS,32,28,29,89,2000,Sydney,AUS," $259,710,000,000.00 "
Ukraine,UKR,3,10,10,23,2000,Sydney,AUS," $31,261,718,319.00 "
United States,USA,37,24,32,93,2000,Sydney,AUS," $10,252,300,000,000.00 "
Croatia,HRV,1,0,1,2,2000,Sydney,AUS," $21,633,759,451.00 "
Austria,AUT,2,1,0,3,2000,Sydney,AUS," $196,800,000,000.00 "
Mexico,MEX,1,2,3,6,2000,Sydney,AUS," $707,907,000,000.00 "
Uruguay,URY,0,1,0,1,2000,Sydney,AUS," $22,823,255,802.00 "
Uzbekistan,UZB,1,1,2,4,2000,Sydney,AUS," $13,760,513,969.00 "
Barbados,BRB,0,0,1,1,2000,Sydney,AUS," $3,059,500,000.00 "
Costa Rica,CRI,0,0,2,2,2000,Sydney,AUS," $15,013,629,665.00 "
Slovakia,SVK,1,3,1,5,2000,Sydney,AUS," $29,169,953,013.00 "
Norway,NOR,4,3,3,10,2000,Sydney,AUS," $171,247,000,000.00 "
Denmark,DNK,2,3,1,6,2000,Sydney,AUS," $164,159,000,000.00 "
Bulgaria,BGR,5,6,2,13,2000,Sydney,AUS," $13,245,833,844.00 "
Czech Republic,CZE,2,3,3,8,2000,Sydney,AUS," $61,828,166,496.00 "
Cuba,CUB,11,11,7,29,2000,Sydney,AUS," $30,565,400,000.00 "
Ethiopia,ETH,4,1,3,8,2000,Sydney,AUS," $8,242,392,104.00 "
Cameroon,CMR,1,0,0,1,2000,Sydney,AUS," $10,109,045,071.00 "
Netherlands,NLD,12,9,4,25,2000,Sydney,AUS," $416,443,000,000.00 "
United Kingdom,GBR,11,10,7,28,2000,Sydney,AUS," $1,658,190,000,000.00 "
Serbia and Montenegro,SCG,1,1,1,3,2000,Sydney,AUS,
Turkey,TUR,3,0,2,5,2000,Sydney,AUS," $274,303,000,000.00 "
Greece,GRC,6,6,4,16,2004,Athens,GRC," $240,521,000,000.00 "
Trinidad and Tobago,TTO,0,0,1,1,2004,Athens,GRC," $13,280,275,123.00 "
Switzerland,CHE,1,1,3,5,2004,Athens,GRC," $405,531,000,000.00 "
Israel,ISR,1,0,1,2,2004,Athens,GRC," $135,728,000,000.00 "
Iran,IRN,2,2,2,6,2004,Athens,GRC," $190,043,000,000.00 "
Jamaica,JAM,2,1,2,5,2004,Athens,GRC," $10,174,664,854.00 "
Spain,ESP,3,11,6,20,2004,Athens,GRC," $1,067,090,000,000.00 "
Hong Kong,HKG,0,1,0,1,2004,Athens,GRC," $169,100,000,000.00 "
Indonesia,IDN,1,1,2,4,2004,Athens,GRC," $256,837,000,000.00 "
Japan,JPN,16,9,12,37,2004,Athens,GRC," $4,815,150,000,000.00 "
India,IND,0,1,0,1,2004,Athens,GRC," $709,149,000,000.00 "
Zimbabwe,ZWE,1,1,1,3,2004,Athens,GRC," $5,805,598,400.00 "
Kazakhstan,KAZ,1,4,3,8,2004,Athens,GRC," $43,151,647,003.00 "
Hungary,HUN,8,6,3,17,2004,Athens,GRC," $103,960,000,000.00 "
Dominican Republic,DOM,1,0,0,1,2004,Athens,GRC," $22,322,395,368.00 "
Sweden,SWE,4,2,1,7,2004,Athens,GRC," $385,118,000,000.00 "
Netherlands,NLD,4,9,9,22,2004,Athens,GRC," $657,172,000,000.00 "
Colombia,COL,0,0,2,2,2004,Athens,GRC," $117,082,000,000.00 "
Serbia and Montenegro,SCG,0,2,0,2,2004,Athens,GRC,
Slovakia,SVK,2,2,2,6,2004,Athens,GRC," $57,332,015,148.00 "
China,CHN,32,17,14,63,2004,Athens,GRC," $1,955,350,000,000.00 "
Eritrea,ERI,0,0,1,1,2004,Athens,GRC," $1,109,054,005.00 "
Egypt,EGY,1,1,3,5,2004,Athens,GRC," $78,782,467,532.00 "
Mongolia,MNG,0,0,1,1,2004,Athens,GRC," $1,992,066,808.00 "
Chinese Taipei,TPE,2,2,1,5,2004,Athens,GRC,
New Zealand,NZL,3,2,0,5,2004,Athens,GRC," $103,905,000,000.00 "
United Arab Emirates,ARE,1,0,0,1,2004,Athens,GRC," $147,824,000,000.00 "
Cuba,CUB,9,7,11,27,2004,Athens,GRC," $38,203,000,000.00 "
Croatia,HRV,1,2,2,5,2004,Athens,GRC," $41,587,470,547.00 "
Denmark,DNK,2,1,5,8,2004,Athens,GRC," $251,373,000,000.00 "
Morocco,MAR,2,1,0,3,2004,Athens,GRC," $59,626,020,162.00 "
Turkey,TUR,3,3,4,10,2004,Athens,GRC," $408,876,000,000.00 "
Ukraine,UKR,8,5,9,22,2004,Athens,GRC," $64,819,702,952.00 "
Czech Republic,CZE,1,3,5,9,2004,Athens,GRC," $119,814,000,000.00 "
Estonia,EST,0,1,2,3,2004,Athens,GRC," $12,144,397,516.00 "
Slovenia,SVN,0,1,3,4,2004,Athens,GRC," $34,414,784,504.00 "
Kenya,KEN,1,4,2,7,2004,Athens,GRC," $16,095,337,094.00 "
Syria,SYR,0,0,1,1,2004,Athens,GRC," $25,086,930,693.00 "
North Korea,PRK,0,4,1,5,2004,Athens,GRC, $-   
Argentina,ARG,2,0,4,6,2004,Athens,GRC," $164,658,000,000.00 "
Norway,NOR,5,0,1,6,2004,Athens,GRC," $264,512,000,000.00 "
Portugal,PRT,0,2,1,3,2004,Athens,GRC," $189,035,000,000.00 "
Cameroon,CMR,1,0,0,1,2004,Athens,GRC," $17,462,229,589.00 "
Belarus,BLR,2,5,6,13,2004,Athens,GRC," $23,144,351,852.00 "
Paraguay,PRY,0,1,0,1,2004,Athens,GRC," $9,624,440,836.00 "
Bahamas,BHS,1,0,1,2,2004,Athens,GRC," $9,055,290,000.00 "
Romania,ROU,8,5,6,19,2004,Athens,GRC," $74,972,669,057.00 "
Uzbekistan,UZB,2,1,2,5,2004,Athens,GRC," $12,030,023,548.00 "
Nigeria,NGA,0,0,2,2,2004,Athens,GRC," $136,386,000,000.00 "
Russia,RUS,28,26,36,90,2004,Athens,GRC," $591,017,000,000.00 "
Bulgaria,BGR,2,1,9,12,2004,Athens,GRC," $26,157,894,737.00 "
Poland,POL,3,2,5,10,2004,Athens,GRC," $255,110,000,000.00 "
South Korea,KOR,9,12,9,30,2004,Athens,GRC," $793,175,000,000.00 "
United Kingdom,GBR,9,9,12,30,2004,Athens,GRC," $2,412,050,000,000.00 "
Azerbaijan,AZE,1,0,4,5,2004,Athens,GRC," $8,680,370,408.00 "
Canada,CAN,3,6,3,12,2004,Athens,GRC," $1,026,690,000,000.00 "
Venezuela,VEN,0,0,2,2,2004,Athens,GRC," $112,453,000,000.00 "
Latvia,LVA,0,4,0,4,2004,Athens,GRC," $14,401,882,399.00 "
Austria,AUT,2,4,1,7,2004,Athens,GRC," $300,904,000,000.00 "
Germany,DEU,13,16,20,49,2004,Athens,GRC," $2,809,190,000,000.00 "
Georgia,GEO,2,2,0,4,2004,Athens,GRC," $5,125,365,192.00 "
Lithuania,LTU,1,2,0,3,2004,Athens,GRC," $22,627,507,452.00 "
France,FRA,11,9,13,33,2004,Athens,GRC," $2,115,740,000,000.00 "
South Africa,ZAF,1,3,2,6,2004,Athens,GRC," $228,590,000,000.00 "
Chile,CHL,2,0,1,3,2004,Athens,GRC," $99,210,392,858.00 "
Thailand,THA,3,1,4,8,2004,Athens,GRC," $172,896,000,000.00 "
Ethiopia,ETH,2,3,2,7,2004,Athens,GRC," $10,131,187,261.00 "
Brazil,BRA,5,2,3,10,2004,Athens,GRC," $669,317,000,000.00 "
United States,USA,36,39,26,101,2004,Athens,GRC," $12,213,700,000,000.00 "
Belgium,BEL,1,0,2,3,2004,Athens,GRC," $368,537,000,000.00 "
Australia,AUS,17,16,17,50,2004,Athens,GRC," $612,490,000,000.00 "
Finland,FIN,0,2,0,2,2004,Athens,GRC," $197,117,000,000.00 "
Mexico,MEX,0,3,1,4,2004,Athens,GRC," $782,241,000,000.00 "
Italy,ITA,10,11,11,32,2004,Athens,GRC," $1,803,230,000,000.00 "
France,FRA,7,16,20,43,2008,Beijing,CHN," $2,918,380,000,000.00 "
Jamaica,JAM,5,4,2,11,2008,Beijing,CHN," $13,709,402,085.00 "
Egypt,EGY,0,0,2,2,2008,Beijing,CHN," $162,818,000,000.00 "
Estonia,EST,1,1,0,2,2008,Beijing,CHN," $24,371,299,253.00 "
Ethiopia,ETH,4,2,1,7,2008,Beijing,CHN," $27,066,912,635.00 "
Italy,ITA,8,9,10,27,2008,Beijing,CHN," $2,398,860,000,000.00 "
Israel,ISR,0,0,1,1,2008,Beijing,CHN," $216,339,000,000.00 "
Finland,FIN,1,1,2,4,2008,Beijing,CHN," $284,554,000,000.00 "
Japan,JPN,9,8,8,25,2008,Beijing,CHN," $5,037,910,000,000.00 "
Iceland,ISL,0,1,0,1,2008,Beijing,CHN," $18,074,622,987.00 "
Iran,IRN,1,0,1,2,2008,Beijing,CHN," $412,336,000,000.00 "
Indonesia,IDN,1,1,4,6,2008,Beijing,CHN," $510,229,000,000.00 "
Georgia,GEO,3,2,2,7,2008,Beijing,CHN," $12,795,076,469.00 "
Germany,DEU,16,11,14,41,2008,Beijing,CHN," $3,730,030,000,000.00 "
Greece,GRC,0,2,1,3,2008,Beijing,CHN," $354,461,000,000.00 "
India,IND,1,0,2,3,2008,Beijing,CHN," $1,198,900,000,000.00 "
Ecuador,ECU,0,1,0,1,2008,Beijing,CHN," $61,762,635,000.00 "
Ireland,IRL,0,1,2,3,2008,Beijing,CHN," $274,820,000,000.00 "
Cameroon,CMR,1,0,0,1,2008,Beijing,CHN," $26,516,681,614.00 "
Canada,CAN,3,9,8,20,2008,Beijing,CHN," $1,552,990,000,000.00 "
Morocco,MAR,0,1,1,2,2008,Beijing,CHN," $92,507,257,784.00 "
Armenia,ARM,0,1,4,5,2008,Beijing,CHN," $11,662,040,714.00 "
Dominican Republic,DOM,1,1,0,2,2008,Beijing,CHN," $48,122,547,177.00 "
Austria,AUT,0,1,2,3,2008,Beijing,CHN," $430,294,000,000.00 "
Azerbaijan,AZE,1,1,4,6,2008,Beijing,CHN," $48,852,482,960.00 "
North Korea,PRK,2,2,2,6,2008,Beijing,CHN, $-   
Bulgaria,BGR,1,1,3,5,2008,Beijing,CHN," $54,438,966,420.00 "
Algeria,DZA,0,1,1,2,2008,Beijing,CHN," $171,001,000,000.00 "
Brazil,BRA,3,4,10,17,2008,Beijing,CHN," $1,695,820,000,000.00 "
Netherlands,NLD,7,5,4,16,2008,Beijing,CHN," $947,998,000,000.00 "
Australia,AUS,14,15,17,46,2008,Beijing,CHN," $1,054,000,000,000.00 "
Argentina,ARG,2,0,4,6,2008,Beijing,CHN," $361,558,000,000.00 "
Bahamas,BHS,0,1,1,2,2008,Beijing,CHN," $10,526,000,000.00 "
Portugal,PRT,1,1,0,2,2008,Beijing,CHN," $262,345,000,000.00 "
Belgium,BEL,2,0,0,2,2008,Beijing,CHN," $515,224,000,000.00 "
Nigeria,NGA,0,3,2,5,2008,Beijing,CHN," $337,036,000,000.00 "
Panama,PAN,1,0,0,1,2008,Beijing,CHN," $25,155,888,600.00 "
New Zealand,NZL,3,2,4,9,2008,Beijing,CHN," $133,131,000,000.00 "
Norway,NOR,3,5,1,9,2008,Beijing,CHN," $462,250,000,000.00 "
Poland,POL,4,5,2,11,2008,Beijing,CHN," $533,609,000,000.00 "
Belarus,BLR,3,4,7,14,2008,Beijing,CHN," $60,763,483,146.00 "
Malaysia,MYS,0,1,0,1,2008,Beijing,CHN," $230,814,000,000.00 "
Mongolia,MNG,2,2,0,4,2008,Beijing,CHN," $5,623,216,449.00 "
Latvia,LVA,1,1,1,3,2008,Beijing,CHN," $35,756,225,698.00 "
Moldova,MDA,0,0,1,1,2008,Beijing,CHN," $6,054,849,885.00 "
Sudan,SDN,0,1,0,1,2008,Beijing,CHN," $54,526,580,232.00 "
Singapore,SGP,0,1,0,1,2008,Beijing,CHN," $193,612,000,000.00 "
Uzbekistan,UZB,0,1,3,4,2008,Beijing,CHN," $29,549,438,884.00 "
Venezuela,VEN,0,0,1,1,2008,Beijing,CHN," $315,953,000,000.00 "
Thailand,THA,2,2,2,6,2008,Beijing,CHN," $291,383,000,000.00 "
Togo,TGO,0,0,1,1,2008,Beijing,CHN," $3,323,677,130.00 "
Slovakia,SVK,3,3,0,6,2008,Beijing,CHN," $100,470,000,000.00 "
Slovenia,SVN,1,2,2,5,2008,Beijing,CHN," $55,552,509,155.00 "
Tajikistan,TJK,0,1,1,2,2008,Beijing,CHN," $5,161,337,336.00 "
Trinidad and Tobago,TTO,1,1,0,2,2008,Beijing,CHN," $27,871,587,350.00 "
United Kingdom,GBR,19,13,19,51,2008,Beijing,CHN," $2,921,430,000,000.00 "
United States,USA,36,39,37,112,2008,Beijing,CHN," $14,712,800,000,000.00 "
Vietnam,VNM,0,1,0,1,2008,Beijing,CHN," $99,130,304,099.00 "
Samoa,WSM,0,1,0,1,2008,Beijing,CHN," $619,260,721.60 "
Ukraine,UKR,7,4,11,22,2008,Beijing,CHN," $179,817,000,000.00 "
Sweden,SWE,0,4,1,5,2008,Beijing,CHN," $517,706,000,000.00 "
Spain,ESP,5,11,3,19,2008,Beijing,CHN," $1,625,220,000,000.00 "
Serbia,SRB,0,1,2,3,2008,Beijing,CHN," $52,194,221,469.00 "
Switzerland,CHE,2,1,4,7,2008,Beijing,CHN," $570,304,000,000.00 "
Romania,ROU,4,1,4,9,2008,Beijing,CHN," $214,314,000,000.00 "
Tunisia,TUN,1,0,0,1,2008,Beijing,CHN," $44,860,969,077.00 "
Turkey,TUR,1,1,3,5,2008,Beijing,CHN," $770,462,000,000.00 "
South Korea,KOR,13,11,8,32,2008,Beijing,CHN," $1,047,340,000,000.00 "
China,CHN,48,22,30,100,2008,Beijing,CHN," $4,594,310,000,000.00 "
Chinese Taipei,TPE,1,1,2,4,2008,Beijing,CHN,
Mexico,MEX,2,0,2,4,2008,Beijing,CHN," $1,109,990,000,000.00 "
Mauritius,MUS,0,0,1,1,2008,Beijing,CHN," $9,990,370,016.00 "
Hungary,HUN,3,5,2,10,2008,Beijing,CHN," $158,136,000,000.00 "
Croatia,HRV,0,2,3,5,2008,Beijing,CHN," $70,234,425,974.00 "
Kazakhstan,KAZ,2,3,4,9,2008,Beijing,CHN," $133,442,000,000.00 "
Lithuania,LTU,0,3,2,5,2008,Beijing,CHN," $47,797,551,588.00 "
Chile,CHL,0,1,0,1,2008,Beijing,CHN," $179,638,000,000.00 "
Cuba,CUB,3,10,17,30,2008,Beijing,CHN," $60,806,300,000.00 "
Kyrgyzstan,KGZ,0,1,2,3,2008,Beijing,CHN," $5,139,957,785.00 "
South Africa,ZAF,0,1,0,1,2008,Beijing,CHN," $286,770,000,000.00 "
Russia,RUS,24,13,23,60,2008,Beijing,CHN," $1,660,850,000,000.00 "
Afghanistan,AFG,0,0,1,1,2008,Beijing,CHN," $10,109,225,814.00 "
Colombia,COL,0,2,1,3,2008,Beijing,CHN," $242,187,000,000.00 "
Denmark,DNK,2,2,3,7,2008,Beijing,CHN," $353,361,000,000.00 "
Czech Republic,CZE,3,3,1,7,2008,Beijing,CHN," $236,816,000,000.00 "
Kenya,KEN,6,4,6,16,2008,Beijing,CHN," $35,895,153,328.00 "
Zimbabwe,ZWE,1,3,0,4,2008,Beijing,CHN," $4,415,702,800.00 "
Lithuania,LTU,2,0,3,5,2012,London,GBR," $42,927,454,291.00 "
Latvia,LVA,1,0,1,2,2012,London,GBR," $28,324,787,664.00 "
Kuwait,KWT,0,0,1,1,2012,London,GBR," $174,070,000,000.00 "
Netherlands,NLD,6,6,8,20,2012,London,GBR," $838,971,000,000.00 "
Kenya,KEN,2,4,7,13,2012,London,GBR," $50,412,754,861.00 "
South Korea,KOR,13,9,8,30,2012,London,GBR," $1,278,430,000,000.00 "
Serbia,SRB,1,1,2,4,2012,London,GBR," $43,309,252,921.00 "
New Zealand,NZL,6,2,5,13,2012,London,GBR," $176,207,000,000.00 "
Saudi Arabia,SAU,0,0,1,1,2012,London,GBR," $735,975,000,000.00 "
Japan,JPN,7,14,17,38,2012,London,GBR," $6,203,210,000,000.00 "
Slovakia,SVK,0,1,3,4,2012,London,GBR," $94,534,730,681.00 "
Singapore,SGP,0,0,2,2,2012,London,GBR," $295,087,000,000.00 "
Spain,ESP,4,10,4,18,2012,London,GBR," $1,324,820,000,000.00 "
Russia,RUS,20,20,27,67,2012,London,GBR," $2,208,300,000,000.00 "
Germany,DEU,11,20,13,44,2012,London,GBR," $3,527,340,000,000.00 "
Qatar,QAT,0,0,2,2,2012,London,GBR," $186,834,000,000.00 "
Grenada,GRD,1,0,0,1,2012,London,GBR," $799,882,259.30 "
Kazakhstan,KAZ,3,1,7,11,2012,London,GBR," $207,999,000,000.00 "
Jamaica,JAM,4,5,3,12,2012,London,GBR," $14,807,086,889.00 "
Ireland,IRL,1,1,4,6,2012,London,GBR," $224,984,000,000.00 "
Guatemala,GTM,0,1,0,1,2012,London,GBR," $49,593,961,142.00 "
Egypt,EGY,0,3,1,4,2012,London,GBR," $279,117,000,000.00 "
Hong Kong,HKG,0,0,1,1,2012,London,GBR," $262,629,000,000.00 "
Norway,NOR,2,1,1,4,2012,London,GBR," $509,506,000,000.00 "
Romania,ROU,2,4,1,7,2012,London,GBR," $170,636,000,000.00 "
Hungary,HUN,8,4,6,18,2012,London,GBR," $128,475,000,000.00 "
Puerto Rico,PRI,0,1,1,2,2012,London,GBR," $101,565,000,000.00 "
Poland,POL,3,2,6,11,2012,London,GBR," $498,524,000,000.00 "
Iran,IRN,7,5,1,13,2012,London,GBR," $598,868,000,000.00 "
Portugal,PRT,0,1,0,1,2012,London,GBR," $216,237,000,000.00 "
Indonesia,IDN,0,2,1,3,2012,London,GBR," $917,870,000,000.00 "
Sweden,SWE,1,4,3,8,2012,London,GBR," $552,484,000,000.00 "
India,IND,0,2,4,6,2012,London,GBR," $1,827,640,000,000.00 "
Mongolia,MNG,0,2,3,5,2012,London,GBR," $12,292,770,631.00 "
Italy,ITA,8,9,11,28,2012,London,GBR," $2,087,080,000,000.00 "
North Korea,PRK,4,0,2,6,2012,London,GBR, $-   
Mexico,MEX,1,3,4,8,2012,London,GBR," $1,201,090,000,000.00 "
Slovenia,SVN,1,1,2,4,2012,London,GBR," $46,580,457,470.00 "
Montenegro,MNE,0,1,0,1,2012,London,GBR," $4,087,725,813.00 "
Morocco,MAR,0,0,1,1,2012,London,GBR," $98,266,306,615.00 "
Malaysia,MYS,0,1,1,2,2012,London,GBR," $314,443,000,000.00 "
Azerbaijan,AZE,2,2,5,9,2012,London,GBR," $69,683,935,845.00 "
South Africa,ZAF,4,1,1,6,2012,London,GBR," $396,333,000,000.00 "
Uzbekistan,UZB,0,0,3,3,2012,London,GBR," $63,628,854,499.00 "
Vietnam,VNM,0,0,1,1,2012,London,GBR," $155,820,000,000.00 "
Switzerland,CHE,2,2,0,4,2012,London,GBR," $692,110,000,000.00 "
Greece,GRC,0,0,2,2,2012,London,GBR," $242,054,000,000.00 "
Afghanistan,AFG,0,0,1,1,2012,London,GBR," $20,001,598,506.00 "
Algeria,DZA,1,0,0,1,2012,London,GBR," $209,059,000,000.00 "
Tajikistan,TJK,0,0,1,1,2012,London,GBR," $7,633,049,792.00 "
Denmark,DNK,2,4,3,9,2012,London,GBR," $327,149,000,000.00 "
Argentina,ARG,1,1,2,4,2012,London,GBR," $545,982,000,000.00 "
Venezuela,VEN,1,0,0,1,2012,London,GBR," $381,286,000,000.00 "
Gabon,GAB,0,1,0,1,2012,London,GBR," $17,170,465,294.00 "
Thailand,THA,0,2,2,4,2012,London,GBR," $397,558,000,000.00 "
Armenia,ARM,0,1,1,2,2012,London,GBR," $10,619,320,049.00 "
Finland,FIN,0,2,1,3,2012,London,GBR," $258,305,000,000.00 "
Cameroon,CMR,0,0,1,1,2012,London,GBR," $29,102,772,799.00 "
Estonia,EST,0,1,1,2,2012,London,GBR," $23,192,708,982.00 "
Ethiopia,ETH,3,2,3,8,2012,London,GBR," $43,310,721,414.00 "
Australia,AUS,8,15,12,35,2012,London,GBR," $1,546,150,000,000.00 "
Trinidad and Tobago,TTO,1,1,2,4,2012,London,GBR," $25,763,220,107.00 "
France,FRA,11,11,13,35,2012,London,GBR," $2,683,830,000,000.00 "
Dominican Republic,DOM,1,1,0,2,2012,London,GBR," $60,681,537,196.00 "
Georgia,GEO,1,2,3,6,2012,London,GBR," $16,488,403,076.00 "
United Kingdom,GBR,29,17,19,65,2012,London,GBR," $2,704,020,000,000.00 "
Tunisia,TUN,2,0,1,3,2012,London,GBR," $45,044,138,549.00 "
Bahamas,BHS,1,0,0,1,2012,London,GBR," $10,720,500,000.00 "
Cyprus,CYP,0,1,0,1,2012,London,GBR," $24,978,513,427.00 "
Turkey,TUR,1,1,1,3,2012,London,GBR," $880,556,000,000.00 "
Cuba,CUB,5,3,7,15,2012,London,GBR," $73,141,000,000.00 "
Bahrain,BHR,1,0,0,1,2012,London,GBR," $30,749,308,511.00 "
United States,USA,46,28,30,104,2012,London,GBR," $16,197,000,000,000.00 "
Croatia,HRV,3,1,2,6,2012,London,GBR," $56,580,819,624.00 "
Uganda,UGA,1,0,0,1,2012,London,GBR," $27,188,667,093.00 "
Czech Republic,CZE,4,3,4,11,2012,London,GBR," $208,858,000,000.00 "
Colombia,COL,1,3,5,9,2012,London,GBR," $370,921,000,000.00 "
Belarus,BLR,2,5,3,10,2012,London,GBR," $65,685,102,555.00 "
Bulgaria,BGR,0,2,1,3,2012,London,GBR," $54,033,250,329.00 "
Brazil,BRA,3,5,9,17,2012,London,GBR," $2,465,190,000,000.00 "
China,CHN,38,31,22,91,2012,London,GBR," $8,532,230,000,000.00 "
Canada,CAN,2,5,11,18,2012,London,GBR," $1,828,370,000,000.00 "
Chinese Taipei,TPE,1,0,1,2,2012,London,GBR,
Ukraine,UKR,5,4,10,19,2012,London,GBR," $175,781,000,000.00 "
Belgium,BEL,0,1,2,3,2012,London,GBR," $496,181,000,000.00 "
Botswana,BWA,0,1,0,1,2012,London,GBR," $14,380,004,175.00 "
Hungary,HUN,8,3,4,15,2016,Rio de Janeiro,BRA," $128,471,000,000.00 "
Jamaica,JAM,6,3,2,11,2016,Rio de Janeiro,BRA," $14,077,109,397.00 "
Spain,ESP,7,4,6,17,2016,Rio de Janeiro,BRA," $1,232,080,000,000.00 "
Slovakia,SVK,2,2,0,4,2016,Rio de Janeiro,BRA," $89,655,253,976.00 "
France,FRA,10,18,14,42,2016,Rio de Janeiro,BRA," $2,471,290,000,000.00 "
Greece,GRC,3,1,2,6,2016,Rio de Janeiro,BRA," $192,732,000,000.00 "
Switzerland,CHE,3,2,2,7,2016,Rio de Janeiro,BRA," $695,601,000,000.00 "
Germany,DEU,17,10,15,42,2016,Rio de Janeiro,BRA," $3,467,500,000,000.00 "
Georgia,GEO,2,1,4,7,2016,Rio de Janeiro,BRA," $15,141,758,567.00 "
India,IND,0,1,1,2,2016,Rio de Janeiro,BRA," $2,294,800,000,000.00 "
Tajikistan,TJK,1,0,0,1,2016,Rio de Janeiro,BRA," $6,992,393,787.00 "
Sweden,SWE,2,6,3,11,2016,Rio de Janeiro,BRA," $515,655,000,000.00 "
Individual Olympic Athletes,IOA,1,0,1,2,2016,Rio de Janeiro,BRA,
Indonesia,IDN,1,2,0,3,2016,Rio de Janeiro,BRA," $931,877,000,000.00 "
Trinidad and Tobago,TTO,0,0,1,1,2016,Rio de Janeiro,BRA," $22,386,264,807.00 "
Finland,FIN,0,0,1,1,2016,Rio de Janeiro,BRA," $240,608,000,000.00 "
Iran,IRN,3,1,4,8,2016,Rio de Janeiro,BRA," $417,984,000,000.00 "
Qatar,QAT,0,1,0,1,2016,Rio de Janeiro,BRA," $151,732,000,000.00 "
Mexico,MEX,0,3,2,5,2016,Rio de Janeiro,BRA," $1,078,490,000,000.00 "
Tunisia,TUN,0,0,3,3,2016,Rio de Janeiro,BRA," $41,801,284,916.00 "
Slovenia,SVN,1,2,1,4,2016,Rio de Janeiro,BRA," $44,736,333,522.00 "
Thailand,THA,2,2,2,6,2016,Rio de Janeiro,BRA," $413,366,000,000.00 "
Dominican Republic,DOM,0,0,1,1,2016,Rio de Janeiro,BRA," $75,704,720,190.00 "
Japan,JPN,12,8,21,41,2016,Rio de Janeiro,BRA," $4,922,540,000,000.00 "
Jordan,JOR,1,0,0,1,2016,Rio de Janeiro,BRA," $39,892,551,127.00 "
Denmark,DNK,2,6,7,15,2016,Rio de Janeiro,BRA," $313,116,000,000.00 "
Kazakhstan,KAZ,3,5,10,18,2016,Rio de Janeiro,BRA," $137,278,000,000.00 "
Czech Republic,CZE,1,2,7,10,2016,Rio de Janeiro,BRA," $196,272,000,000.00 "
South Korea,KOR,9,3,9,21,2016,Rio de Janeiro,BRA," $1,500,110,000,000.00 "
Kenya,KEN,6,6,1,13,2016,Rio de Janeiro,BRA," $69,188,755,364.00 "
Turkey,TUR,1,3,4,8,2016,Rio de Janeiro,BRA," $869,693,000,000.00 "
Kosovo,XKX,1,0,0,1,2016,Rio de Janeiro,BRA," $6,719,172,017.00 "
Egypt,EGY,0,0,3,3,2016,Rio de Janeiro,BRA," $332,442,000,000.00 "
Croatia,HRV,5,3,2,10,2016,Rio de Janeiro,BRA," $51,601,147,666.00 "
Lithuania,LTU,0,1,3,4,2016,Rio de Janeiro,BRA," $43,018,087,238.00 "
Colombia,COL,3,2,3,8,2016,Rio de Janeiro,BRA," $282,825,000,000.00 "
South Africa,ZAF,2,6,2,10,2016,Rio de Janeiro,BRA," $296,357,000,000.00 "
Chinese Taipei,TPE,1,0,2,3,2016,Rio de Janeiro,BRA,
Malaysia,MYS,0,4,1,5,2016,Rio de Janeiro,BRA," $301,255,000,000.00 "
United Arab Emirates,ARE,0,0,1,1,2016,Rio de Janeiro,BRA," $357,045,000,000.00 "
China,CHN,26,18,26,70,2016,Rio de Janeiro,BRA," $11,233,300,000,000.00 "
Ireland,IRL,0,2,0,2,2016,Rio de Janeiro,BRA," $299,556,000,000.00 "
Norway,NOR,0,0,4,4,2016,Rio de Janeiro,BRA," $368,827,000,000.00 "
Ethiopia,ETH,1,2,5,8,2016,Rio de Janeiro,BRA," $74,296,618,481.00 "
Nigeria,NGA,0,0,1,1,2016,Rio de Janeiro,BRA," $404,650,000,000.00 "
Australia,AUS,8,11,10,29,2016,Rio de Janeiro,BRA," $1,208,850,000,000.00 "
Netherlands,NLD,8,7,4,19,2016,Rio de Janeiro,BRA," $783,528,000,000.00 "
Serbia,SRB,2,4,2,8,2016,Rio de Janeiro,BRA," $40,692,643,373.00 "
North Korea,PRK,2,3,2,7,2016,Rio de Janeiro,BRA, $-   
Morocco,MAR,0,0,1,1,2016,Rio de Janeiro,BRA," $103,312,000,000.00 "
Mongolia,MNG,0,1,1,2,2016,Rio de Janeiro,BRA," $11,186,734,674.00 "
Argentina,ARG,3,1,0,4,2016,Rio de Janeiro,BRA," $557,531,000,000.00 "
Azerbaijan,AZE,1,7,10,18,2016,Rio de Janeiro,BRA," $37,867,518,957.00 "
Poland,POL,2,3,6,11,2016,Rio de Janeiro,BRA," $472,630,000,000.00 "
Brazil,BRA,7,6,6,19,2016,Rio de Janeiro,BRA," $1,795,700,000,000.00 "
Singapore,SGP,1,0,0,1,2016,Rio de Janeiro,BRA," $318,764,000,000.00 "
Burundi,BDI,0,1,0,1,2016,Rio de Janeiro,BRA," $2,959,641,047.00 "
Algeria,DZA,0,2,0,2,2016,Rio de Janeiro,BRA," $160,034,000,000.00 "
Portugal,PRT,0,0,1,1,2016,Rio de Janeiro,BRA," $206,286,000,000.00 "
Bulgaria,BGR,0,1,2,3,2016,Rio de Janeiro,BRA," $53,806,894,796.00 "
United Kingdom,GBR,27,23,17,67,2016,Rio de Janeiro,BRA," $2,693,250,000,000.00 "
Cuba,CUB,5,2,4,11,2016,Rio de Janeiro,BRA," $91,370,000,000.00 "
Puerto Rico,PRI,1,0,0,1,2016,Rio de Janeiro,BRA," $104,337,000,000.00 "
Fiji,FJI,1,0,0,1,2016,Rio de Janeiro,BRA," $4,930,204,230.00 "
Uzbekistan,UZB,4,2,7,13,2016,Rio de Janeiro,BRA," $81,779,012,351.00 "
Venezuela,VEN,0,2,1,3,2016,Rio de Janeiro,BRA, $-   
Israel,ISR,0,0,2,2,2016,Rio de Janeiro,BRA," $318,617,000,000.00 "
Estonia,EST,0,0,1,1,2016,Rio de Janeiro,BRA," $24,259,552,889.00 "
Italy,ITA,8,12,8,28,2016,Rio de Janeiro,BRA," $1,875,800,000,000.00 "
Ivory Coast,CIV,1,0,1,2,2016,Rio de Janeiro,BRA," $47,964,234,560.00 "
Canada,CAN,4,3,15,22,2016,Rio de Janeiro,BRA," $1,527,990,000,000.00 "
Grenada,GRD,0,1,0,1,2016,Rio de Janeiro,BRA," $1,061,631,222.00 "
Niger,NER,0,1,0,1,2016,Rio de Janeiro,BRA," $10,355,006,770.00 "
Belgium,BEL,2,2,2,6,2016,Rio de Janeiro,BRA," $475,740,000,000.00 "
Russia,RUS,19,17,20,56,2016,Rio de Janeiro,BRA," $1,276,790,000,000.00 "
Austria,AUT,0,0,1,1,2016,Rio de Janeiro,BRA," $395,569,000,000.00 "
Belarus,BLR,1,4,4,9,2016,Rio de Janeiro,BRA," $47,722,657,821.00 "
Vietnam,VNM,1,1,0,2,2016,Rio de Janeiro,BRA," $205,276,000,000.00 "
Romania,ROU,1,1,2,4,2016,Rio de Janeiro,BRA," $188,129,000,000.00 "
United States,USA,46,37,38,121,2016,Rio de Janeiro,BRA," $18,745,100,000,000.00 "
Bahrain,BHR,1,1,0,2,2016,Rio de Janeiro,BRA," $32,234,973,404.00 "
New Zealand,NZL,4,9,5,18,2016,Rio de Janeiro,BRA," $188,943,000,000.00 "
Bahamas,BHS,1,0,1,2,2016,Rio de Janeiro,BRA," $11,928,500,000.00 "
Philippines,PHL,0,1,0,1,2016,Rio de Janeiro,BRA," $318,627,000,000.00 "
Armenia,ARM,1,3,0,4,2016,Rio de Janeiro,BRA," $10,546,135,160.00 "
Ukraine,UKR,2,5,4,11,2016,Rio de Janeiro,BRA," $93,355,993,629.00 "
