Country,Country Code,Gold,Silver,Bronze,Total,Year,Host_City,Host_Country, GDP (USD Millions) 
Netherlands,NLD,2,4,4,10,1964,Tokyo,JPN,18699380731
Bulgaria,BGR,3,5,2,10,1964,Tokyo,JPN, $-   
Pakistan,PAK,0,1,0,1,1964,Tokyo,JPN,5204955901
Brazil,BRA,0,0,1,1,1964,Tokyo,JPN,21211892260
Italy,ITA,10,10,7,27,1964,Tokyo,JPN,63175417019
Sweden,SWE,2,2,4,8,1964,Tokyo,JPN,22532416750
Uruguay,URY,0,0,1,1,1964,Tokyo,JPN,1975701816
Ireland,IRL,0,0,1,1,1964,Tokyo,JPN,2766608946
Japan,JPN,16,5,8,29,1964,Tokyo,JPN,81749006382
Iran,IRN,0,0,2,2,1964,Tokyo,JPN,5379845648
Cuba,CUB,0,1,0,1,1964,Tokyo,JPN, $-   
Switzerland,CHE,1,2,1,4,1964,Tokyo,JPN,14480556572
India,IND,1,0,0,1,1964,Tokyo,JPN,56480289941
Kenya,KEN,0,0,1,1,1964,Tokyo,JPN,998759333.6
Philippines,PHL,0,1,0,1,1964,Tokyo,JPN,5271404668
Hungary,HUN,10,7,5,22,1964,Tokyo,JPN, $-   
United States,USA,36,26,28,90,1964,Tokyo,JPN,6.858E+11
Romania,ROU,2,4,6,12,1964,Tokyo,JPN, $-   
Yugoslavia,YUG,2,1,2,5,1964,Tokyo,JPN,
Ghana,GHA,0,0,1,1,1964,Tokyo,JPN,1731296119
Argentina,ARG,0,1,0,1,1964,Tokyo,JPN,25605249382
New Zealand,NZL,3,0,2,5,1964,Tokyo,JPN,7274144351
Czech Republic,CZE,5,6,3,14,1964,Tokyo,JPN, $-   
Australia,AUS,6,2,10,18,1964,Tokyo,JPN,23764139321
Russia,RUS,30,31,35,96,1964,Tokyo,JPN, $-   
Germany,DEU,10,22,18,50,1964,Tokyo,JPN, $-   
Poland,POL,7,6,10,23,1964,Tokyo,JPN, $-   
South Korea,KOR,0,2,1,3,1964,Tokyo,JPN,3458939358
France,FRA,1,8,6,15,1964,Tokyo,JPN,94007851047
Mexico,MEX,0,0,1,1,1964,Tokyo,JPN,20080000000
Finland,FIN,3,0,2,5,1964,Tokyo,JPN,7766655086
Canada,CAN,1,2,1,4,1964,Tokyo,JPN,49377522897
Trinidad and Tobago,TTO,0,1,2,3,1964,Tokyo,JPN,711893367.6
United Kingdom,GBR,4,12,2,18,1964,Tokyo,JPN,94407558351
Nigeria,NGA,0,0,1,1,1964,Tokyo,JPN,5552822484
Turkey,TUR,2,3,1,6,1964,Tokyo,JPN,11177777778
Tunisia,TUN,0,1,1,2,1964,Tokyo,JPN, $-   
Denmark,DNK,2,1,3,6,1964,Tokyo,JPN, $-   
Ethiopia,ETH,1,0,0,1,1964,Tokyo,JPN, $-   
Belgium,BEL,2,0,1,3,1964,Tokyo,JPN,15960106681
Bahamas,BHS,1,0,0,1,1964,Tokyo,JPN,266666666.7
Czech Republic,CZE,7,2,4,13,1968,Mexico City,MEX, $-   
France,FRA,7,3,5,15,1968,Mexico City,MEX,1.29785E+11
Mexico,MEX,3,3,3,9,1968,Mexico City,MEX,29360000000
Finland,FIN,1,2,1,4,1968,Mexico City,MEX,8823033880
Mongolia,MNG,0,1,3,4,1968,Mexico City,MEX, $-   
Tunisia,TUN,1,0,1,2,1968,Mexico City,MEX,1214666667
Turkey,TUR,2,0,0,2,1968,Mexico City,MEX,17500000000
Denmark,DNK,1,4,3,8,1968,Mexico City,MEX,13505573867
Netherlands,NLD,3,3,1,7,1968,Mexico City,MEX,27817605743
Germany,DEU,9,9,7,25,1968,Mexico City,MEX, $-   
Poland,POL,5,2,11,18,1968,Mexico City,MEX, $-   
Romania,ROU,4,6,5,15,1968,Mexico City,MEX, $-   
Venezuela,VEN,1,0,0,1,1968,Mexico City,MEX,10034444444
Argentina,ARG,0,0,2,2,1968,Mexico City,MEX,26436857247
Russia,RUS,29,32,30,91,1968,Mexico City,MEX, $-   
Belgium,BEL,0,1,1,2,1968,Mexico City,MEX,21376353113
Australia,AUS,5,7,5,17,1968,Mexico City,MEX,32665472057
Austria,AUT,0,2,2,4,1968,Mexico City,MEX,12440625313
Yugoslavia,YUG,3,3,2,8,1968,Mexico City,MEX,
South Korea,KOR,0,1,1,2,1968,Mexico City,MEX,6119284294
Pakistan,PAK,1,0,0,1,1968,Mexico City,MEX,8041999160
Germany,DEU,5,11,10,26,1968,Mexico City,MEX, $-   
Sweden,SWE,2,1,1,4,1968,Mexico City,MEX,31066819929
Greece,GRC,0,0,1,1,1968,Mexico City,MEX,10090675903
Cuba,CUB,0,4,0,4,1968,Mexico City,MEX, $-   
United Kingdom,GBR,5,5,3,13,1968,Mexico City,MEX,1.0776E+11
Cameroon,CMR,0,1,0,1,1968,Mexico City,MEX,1046191192
Bulgaria,BGR,2,4,3,9,1968,Mexico City,MEX, $-   
Brazil,BRA,0,1,2,3,1968,Mexico City,MEX,33875881876
United States,USA,45,28,34,107,1968,Mexico City,MEX,9.425E+11
New Zealand,NZL,1,0,2,3,1968,Mexico City,MEX,5180597621
Canada,CAN,1,3,1,5,1968,Mexico City,MEX,71829810520
Norway,NOR,1,1,0,2,1968,Mexico City,MEX,10159934137
Ethiopia,ETH,1,1,0,2,1968,Mexico City,MEX, $-   
Chinese Taipei,TPE,0,0,1,1,1968,Mexico City,MEX,
Jamaica,JAM,0,1,0,1,1968,Mexico City,MEX,1083883355
Italy,ITA,3,4,9,16,1968,Mexico City,MEX,87942231678
Japan,JPN,11,7,7,25,1968,Mexico City,MEX,1.46601E+11
Iran,IRN,2,1,2,5,1968,Mexico City,MEX,8623172960
Switzerland,CHE,0,1,4,5,1968,Mexico City,MEX,18942729779
India,IND,0,0,1,1,1968,Mexico City,MEX,53085455871
Hungary,HUN,10,10,12,32,1968,Mexico City,MEX, $-   
Uganda,UGA,0,1,1,2,1968,Mexico City,MEX,1037815126
Kenya,KEN,3,4,2,9,1968,Mexico City,MEX,1353295458
Pakistan,PAK,0,1,0,1,1972,Munich,DEU,9415016360
Germany,DEU,20,23,23,66,1972,Munich,DEU,2.99802E+11
Uganda,UGA,1,1,0,2,1972,Munich,DEU,1491596639
Norway,NOR,2,1,1,4,1972,Munich,DEU,17358610850
Turkey,TUR,0,1,0,1,1972,Munich,DEU,20431095406
Yugoslavia,YUG,2,1,2,5,1972,Munich,DEU,
Niger,NER,0,0,1,1,1972,Munich,DEU,742779740.4
United States,USA,33,31,30,94,1972,Munich,DEU,1.27911E+12
Ghana,GHA,0,0,1,1,1972,Munich,DEU,2112292945
Denmark,DNK,1,0,0,1,1972,Munich,DEU,23232379952
Jamaica,JAM,0,0,1,1,1972,Munich,DEU,1875048860
France,FRA,2,4,7,13,1972,Munich,DEU,2.03494E+11
Romania,ROU,3,6,7,16,1972,Munich,DEU, $-   
Finland,FIN,3,1,4,8,1972,Munich,DEU,14743186120
Mexico,MEX,0,1,0,1,1972,Munich,DEU,45200000000
Sweden,SWE,4,6,6,16,1972,Munich,DEU,48954145809
Brazil,BRA,0,0,2,2,1972,Munich,DEU,58539008786
Russia,RUS,50,27,22,99,1972,Munich,DEU, $-   
Italy,ITA,5,3,10,18,1972,Munich,DEU,1.4526E+11
South Korea,KOR,0,1,0,1,1972,Munich,DEU,10862327878
Australia,AUS,8,7,2,17,1972,Munich,DEU,51967289720
Greece,GRC,0,2,0,2,1972,Munich,DEU,16885511364
Bulgaria,BGR,6,10,5,21,1972,Munich,DEU, $-   
Switzerland,CHE,0,3,0,3,1972,Munich,DEU, $-   
Canada,CAN,0,2,3,5,1972,Munich,DEU,1.13083E+11
India,IND,0,0,1,1,1972,Munich,DEU,71463193830
Colombia,COL,0,1,2,3,1972,Munich,DEU,8671358733
Belgium,BEL,0,2,0,2,1972,Munich,DEU,37209418019
Japan,JPN,13,8,8,29,1972,Munich,DEU,3.18031E+11
Mongolia,MNG,0,1,0,1,1972,Munich,DEU, $-   
Lebanon,LBN,0,1,0,1,1972,Munich,DEU, $-   
Iran,IRN,0,2,1,3,1972,Munich,DEU,17153463263
North Korea,PRK,1,1,3,5,1972,Munich,DEU, $-   
Ethiopia,ETH,0,0,2,2,1972,Munich,DEU, $-   
Tunisia,TUN,0,1,0,1,1972,Munich,DEU,2237476420
Argentina,ARG,0,1,0,1,1972,Munich,DEU,34733000536
Poland,POL,7,5,9,21,1972,Munich,DEU, $-   
United Kingdom,GBR,4,5,9,18,1972,Munich,DEU,1.69965E+11
Austria,AUT,0,1,2,3,1972,Munich,DEU,22059612477
Germany,DEU,13,11,16,40,1972,Munich,DEU,2.99802E+11
Spain,ESP,0,0,1,1,1972,Munich,DEU,59132415221
Netherlands,NLD,3,1,1,5,1972,Munich,DEU,54706557264
Cuba,CUB,3,1,4,8,1972,Munich,DEU,8135150892
Czech Republic,CZE,2,4,2,8,1972,Munich,DEU, $-   
Hungary,HUN,6,13,16,35,1972,Munich,DEU, $-   
Kenya,KEN,2,3,4,9,1972,Munich,DEU,2107279157
New Zealand,NZL,1,1,1,3,1972,Munich,DEU,9567331065
Nigeria,NGA,0,0,1,1,1972,Munich,DEU,12274416018
Bulgaria,BGR,6,9,7,22,1976,Montreal,CAN, $-   
Canada,CAN,0,5,6,11,1976,Montreal,CAN,2.06576E+11
Romania,ROU,4,9,14,27,1976,Montreal,CAN, $-   
South Korea,KOR,1,1,4,6,1976,Montreal,CAN,29902479339
Trinidad and Tobago,TTO,1,0,0,1,1976,Montreal,CAN,2500410584
Germany,DEU,10,12,17,39,1976,Montreal,CAN,5.19754E+11
Netherlands,NLD,0,2,3,5,1976,Montreal,CAN,1.09169E+11
Jamaica,JAM,1,1,0,2,1976,Montreal,CAN,2966010230
Thailand,THA,0,0,1,1,1976,Montreal,CAN,16985211146
Austria,AUT,0,0,1,1,1976,Montreal,CAN,42959976222
Iran,IRN,0,1,1,2,1976,Montreal,CAN,68055295081
Mongolia,MNG,0,1,0,1,1976,Montreal,CAN, $-   
United States,USA,34,35,25,94,1976,Montreal,CAN,1.87341E+12
Finland,FIN,4,2,0,6,1976,Montreal,CAN,31849513771
United Kingdom,GBR,3,5,5,13,1976,Montreal,CAN,2.32615E+11
Russia,RUS,49,41,35,125,1976,Montreal,CAN, $-   
Japan,JPN,9,6,10,25,1976,Montreal,CAN,5.86162E+11
Germany,DEU,40,25,25,90,1976,Montreal,CAN,5.19754E+11
North Korea,PRK,1,1,0,2,1976,Montreal,CAN, $-   
Sweden,SWE,4,1,0,5,1976,Montreal,CAN,89362071673
New Zealand,NZL,2,1,1,4,1976,Montreal,CAN,13604832424
Belgium,BEL,0,3,3,6,1976,Montreal,CAN,71113882968
Italy,ITA,2,7,4,13,1976,Montreal,CAN,2.24717E+11
Bermuda,BMU,0,0,1,1,1976,Montreal,CAN,386300000
Denmark,DNK,1,0,2,3,1976,Montreal,CAN,44575892473
Puerto Rico,PRI,0,0,1,1,1976,Montreal,CAN,8968600000
Brazil,BRA,0,0,2,2,1976,Montreal,CAN,1.52678E+11
Pakistan,PAK,0,0,1,1,1976,Montreal,CAN,13168080808
Venezuela,VEN,0,1,0,1,1976,Montreal,CAN,31419534884
Poland,POL,7,6,13,26,1976,Montreal,CAN, $-   
Yugoslavia,YUG,2,3,3,8,1976,Montreal,CAN,
Mexico,MEX,1,0,1,2,1976,Montreal,CAN,89025974026
Australia,AUS,0,1,4,5,1976,Montreal,CAN,1.04921E+11
Hungary,HUN,4,5,13,22,1976,Montreal,CAN, $-   
Czech Republic,CZE,2,2,4,8,1976,Montreal,CAN, $-   
Portugal,PRT,0,2,0,2,1976,Montreal,CAN,20332831565
France,FRA,2,3,4,9,1976,Montreal,CAN,3.72319E+11
Cuba,CUB,6,4,3,13,1976,Montreal,CAN,13789579903
Spain,ESP,0,2,0,2,1976,Montreal,CAN,1.18507E+11
Norway,NOR,1,1,0,2,1976,Montreal,CAN,35942270686
Switzerland,CHE,1,1,2,4,1976,Montreal,CAN, $-   
Venezuela,VEN,0,1,0,1,1980,Moscow,RUS,59116511628
Jamaica,JAM,0,0,3,3,1980,Moscow,RUS,2679409453
Bulgaria,BGR,8,16,17,41,1980,Moscow,RUS,19839230769
Russia,RUS,80,69,46,195,1980,Moscow,RUS, $-   
India,IND,1,0,0,1,1980,Moscow,RUS,1.86325E+11
Brazil,BRA,2,0,2,4,1980,Moscow,RUS,2.35025E+11
Italy,ITA,8,3,4,15,1980,Moscow,RUS,4.77257E+11
Spain,ESP,1,3,2,6,1980,Moscow,RUS,2.32767E+11
Netherlands,NLD,0,1,2,3,1980,Moscow,RUS,1.95152E+11
Uganda,UGA,0,1,0,1,1980,Moscow,RUS,1244610000
Belgium,BEL,1,0,0,1,1980,Moscow,RUS,1.26829E+11
Cuba,CUB,8,7,5,20,1980,Moscow,RUS,19912889861
Switzerland,CHE,2,0,0,2,1980,Moscow,RUS,1.22661E+11
Poland,POL,3,14,15,32,1980,Moscow,RUS, $-   
Sweden,SWE,3,3,6,12,1980,Moscow,RUS,1.42092E+11
Romania,ROU,6,6,13,25,1980,Moscow,RUS, $-   
Ireland,IRL,0,1,1,2,1980,Moscow,RUS,21751265577
Zimbabwe,ZWE,1,0,0,1,1980,Moscow,RUS,6678868200
United Kingdom,GBR,5,7,9,21,1980,Moscow,RUS,5.64948E+11
Tanzania,TZA,0,2,0,2,1980,Moscow,RUS, $-   
France,FRA,6,5,3,14,1980,Moscow,RUS,7.01288E+11
Mexico,MEX,0,1,3,4,1980,Moscow,RUS,2.05139E+11
Hungary,HUN,7,10,15,32,1980,Moscow,RUS, $-   
Germany,DEU,47,37,42,126,1980,Moscow,RUS,9.50291E+11
Ethiopia,ETH,2,0,2,4,1980,Moscow,RUS, $-   
Czech Republic,CZE,2,3,9,14,1980,Moscow,RUS, $-   
Finland,FIN,3,1,4,8,1980,Moscow,RUS,53645202423
North Korea,PRK,0,3,2,5,1980,Moscow,RUS, $-   
Greece,GRC,1,0,2,3,1980,Moscow,RUS,56829664269
Yugoslavia,YUG,2,3,4,9,1980,Moscow,RUS,
Denmark,DNK,2,1,2,5,1980,Moscow,RUS,71127528700
Mongolia,MNG,0,2,2,4,1980,Moscow,RUS, $-   
Guyana,GUY,0,0,1,1,1980,Moscow,RUS,603200000
Austria,AUT,1,2,1,4,1980,Moscow,RUS,82058912997
Australia,AUS,2,2,5,9,1980,Moscow,RUS,1.49776E+11
Lebanon,LBN,0,0,1,1,1980,Moscow,RUS, $-   
Kenya,KEN,1,0,2,3,1984,Los Angeles,USA,6191437070
Morocco,MAR,2,0,0,2,1984,Los Angeles,USA,14824728528
Dominican Republic,DOM,0,0,1,1,1984,Los Angeles,USA,11594000000
Turkey,TUR,0,0,3,3,1984,Los Angeles,USA,59989909458
Syria,SYR,0,1,0,1,1984,Los Angeles,USA,17503082982
Colombia,COL,0,1,0,1,1984,Los Angeles,USA,38253120738
China,CHN,15,8,9,32,1984,Los Angeles,USA,2.59947E+11
Yugoslavia,YUG,7,4,7,18,1984,Los Angeles,USA,
Puerto Rico,PRI,0,1,1,2,1984,Los Angeles,USA,19162600000
Romania,ROU,20,16,17,53,1984,Los Angeles,USA, $-   
Netherlands,NLD,5,2,6,13,1984,Los Angeles,USA,1.43913E+11
Chinese Taipei,TPE,0,0,1,1,1984,Los Angeles,USA,
Japan,JPN,10,8,14,32,1984,Los Angeles,USA,1.31838E+12
Switzerland,CHE,0,4,4,8,1984,Los Angeles,USA,1.09547E+11
Egypt,EGY,0,1,0,1,1984,Los Angeles,USA,33971188992
South Korea,KOR,6,6,7,19,1984,Los Angeles,USA,97510235986
Venezuela,VEN,0,0,3,3,1984,Los Angeles,USA,60010285714
Nigeria,NGA,0,1,1,2,1984,Los Angeles,USA,73484359521
Denmark,DNK,0,3,3,6,1984,Los Angeles,USA,59105236854
Austria,AUT,1,1,1,3,1984,Los Angeles,USA,67985344887
Spain,ESP,1,2,2,5,1984,Los Angeles,USA,1.72103E+11
Portugal,PRT,1,0,2,3,1984,Los Angeles,USA,25217969050
Greece,GRC,0,1,1,2,1984,Los Angeles,USA,48020024184
New Zealand,NZL,8,1,2,11,1984,Los Angeles,USA,21665975319
Brazil,BRA,1,5,2,8,1984,Los Angeles,USA,2.09024E+11
Iceland,ISL,0,0,1,1,1984,Los Angeles,USA,2864441356
Zambia,ZMB,0,0,1,1,1984,Los Angeles,USA,2739444444
Canada,CAN,10,18,16,44,1984,Los Angeles,USA,3.55373E+11
Sweden,SWE,2,11,6,19,1984,Los Angeles,USA,1.09201E+11
Germany,DEU,17,19,23,59,1984,Los Angeles,USA,7.25111E+11
Ireland,IRL,0,1,0,1,1984,Los Angeles,USA,20109800239
Cameroon,CMR,0,0,1,1,1984,Los Angeles,USA,7311937457
Norway,NOR,0,1,2,3,1984,Los Angeles,USA,62057955033
Belgium,BEL,1,1,2,4,1984,Los Angeles,USA,83349530159
Pakistan,PAK,1,0,0,1,1984,Los Angeles,USA,31151825467
Ivory Coast,CIV,0,1,0,1,1984,Los Angeles,USA,6841638715
France,FRA,5,7,16,28,1984,Los Angeles,USA,5.30684E+11
Peru,PER,0,1,0,1,1984,Los Angeles,USA,17599660054
Algeria,DZA,0,0,2,2,1984,Los Angeles,USA,53698278906
Italy,ITA,14,6,12,32,1984,Los Angeles,USA,4.37888E+11
Australia,AUS,4,8,12,24,1984,Los Angeles,USA,1.93242E+11
Mexico,MEX,2,3,1,6,1984,Los Angeles,USA,1.84261E+11
Jamaica,JAM,0,1,2,3,1984,Los Angeles,USA,2373566957
United Kingdom,GBR,5,11,21,37,1984,Los Angeles,USA,4.61487E+11
Finland,FIN,4,2,6,12,1984,Los Angeles,USA,52888800950
United States,USA,83,61,30,174,1984,Los Angeles,USA,4.03761E+12
Thailand,THA,0,1,0,1,1984,Los Angeles,USA,41797592963
Mongolia,MNG,0,0,1,1,1988,Seoul,KOR,3204461567
Senegal,SEN,0,1,0,1,1988,Seoul,KOR,6418419798
Czech Republic,CZE,3,3,2,8,1988,Seoul,KOR, $-   
U.S. Virgin Islands,VIR,0,1,0,1,1988,Seoul,KOR, $-   
Colombia,COL,0,0,1,1,1988,Seoul,KOR,39212550050
New Zealand,NZL,3,2,8,13,1988,Seoul,KOR,45176811594
Poland,POL,2,5,9,16,1988,Seoul,KOR, $-   
Netherlands,NLD,2,2,5,9,1988,Seoul,KOR,2.61911E+11
Costa Rica,CRI,0,1,0,1,1988,Seoul,KOR,4614629898
Philippines,PHL,0,0,1,1,1988,Seoul,KOR,37885440419
Turkey,TUR,1,1,0,2,1988,Seoul,KOR,90852814005
France,FRA,6,4,6,16,1988,Seoul,KOR,1.01885E+12
Norway,NOR,2,3,0,5,1988,Seoul,KOR,1.019E+11
Finland,FIN,1,1,2,4,1988,Seoul,KOR,1.09059E+11
Romania,ROU,7,11,6,24,1988,Seoul,KOR,40809523810
Brazil,BRA,1,2,3,6,1988,Seoul,KOR,3.30397E+11
Belgium,BEL,0,0,2,2,1988,Seoul,KOR,1.62299E+11
Mexico,MEX,0,0,2,2,1988,Seoul,KOR,1.81612E+11
Peru,PER,0,1,0,1,1988,Seoul,KOR,15439408447
Australia,AUS,3,6,5,14,1988,Seoul,KOR,2.35658E+11
Bulgaria,BGR,10,12,13,35,1988,Seoul,KOR,22555941176
Pakistan,PAK,0,0,1,1,1988,Seoul,KOR,38472742808
Austria,AUT,1,0,0,1,1988,Seoul,KOR,1.33339E+11
Netherlands Antilles,ANT,0,1,0,1,1988,Seoul,KOR,
Denmark,DNK,2,1,1,4,1988,Seoul,KOR,1.15553E+11
United States,USA,36,31,27,94,1988,Seoul,KOR,5.23644E+12
Chile,CHL,0,1,0,1,1988,Seoul,KOR,26040229793
China,CHN,5,11,12,28,1988,Seoul,KOR,3.12354E+11
Thailand,THA,0,0,1,1,1988,Seoul,KOR,61667199835
Switzerland,CHE,0,2,2,4,1988,Seoul,KOR,2.15722E+11
Italy,ITA,6,4,4,14,1988,Seoul,KOR,8.91609E+11
Germany,DEU,11,14,15,40,1988,Seoul,KOR,1.40123E+12
Spain,ESP,1,1,2,4,1988,Seoul,KOR,3.7616E+11
Greece,GRC,0,0,1,1,1988,Seoul,KOR,76261277925
Argentina,ARG,0,1,1,2,1988,Seoul,KOR,1.26207E+11
Indonesia,IDN,0,1,0,1,1988,Seoul,KOR,84300174477
Jamaica,JAM,0,2,0,2,1988,Seoul,KOR,3828310735
Japan,JPN,4,3,7,14,1988,Seoul,KOR,3.07168E+12
Germany,DEU,37,35,30,102,1988,Seoul,KOR,1.40123E+12
South Korea,KOR,12,10,11,33,1988,Seoul,KOR,1.99591E+11
Yugoslavia,YUG,3,4,5,12,1988,Seoul,KOR,
United Kingdom,GBR,5,10,9,24,1988,Seoul,KOR,9.10123E+11
Sweden,SWE,0,4,7,11,1988,Seoul,KOR,2.06987E+11
Morocco,MAR,1,0,2,3,1988,Seoul,KOR,25705296184
Canada,CAN,3,2,5,10,1988,Seoul,KOR,5.07354E+11
Russia,RUS,55,31,46,132,1988,Seoul,KOR,5.54713E+11
Djibouti,DJI,0,0,1,1,1988,Seoul,KOR,395794538.6
Portugal,PRT,1,0,0,1,1988,Seoul,KOR,56347250696
Hungary,HUN,11,6,6,23,1988,Seoul,KOR, $-   
Kenya,KEN,5,2,2,9,1988,Seoul,KOR,8355380879
Iran,IRN,0,1,0,1,1988,Seoul,KOR,1.23058E+11
Suriname,SUR,1,0,0,1,1988,Seoul,KOR,1161000000
Romania,ROU,4,6,8,18,1992,Barcelona,ESP,25121666667
South Korea,KOR,12,5,12,29,1992,Barcelona,ESP,3.55525E+11
Mexico,MEX,0,1,0,1,1992,Barcelona,ESP,3.63158E+11
South Africa,ZAF,0,2,0,2,1992,Barcelona,ESP,1.34545E+11
Estonia,EST,1,0,1,2,1992,Barcelona,ESP, $-   
Germany,DEU,33,21,28,82,1992,Barcelona,ESP,2.13157E+12
Greece,GRC,2,0,0,2,1992,Barcelona,ESP,1.16225E+11
Latvia,LVA,0,2,1,3,1992,Barcelona,ESP, $-   
Ghana,GHA,0,0,1,1,1992,Barcelona,ESP,6413901602
Morocco,MAR,1,1,1,3,1992,Barcelona,ESP,33711069431
Denmark,DNK,1,1,4,6,1992,Barcelona,ESP,1.52916E+11
Finland,FIN,1,2,2,5,1992,Barcelona,ESP,1.12533E+11
Mongolia,MNG,0,0,2,2,1992,Barcelona,ESP,1317611864
Australia,AUS,7,9,11,27,1992,Barcelona,ESP,3.24884E+11
Suriname,SUR,0,0,1,1,1992,Barcelona,ESP,404600000
Thailand,THA,0,0,1,1,1992,Barcelona,ESP,1.11453E+11
France,FRA,8,5,16,29,1992,Barcelona,ESP,1.40147E+12
Ethiopia,ETH,1,0,2,3,1992,Barcelona,ESP,10492993078
Puerto Rico,PRI,0,0,1,1,1992,Barcelona,ESP,34630430000
Netherlands,NLD,2,6,7,15,1992,Barcelona,ESP,3.62963E+11
Hungary,HUN,11,12,7,30,1992,Barcelona,ESP,38730585922
Switzerland,CHE,1,0,0,1,1992,Barcelona,ESP,2.80157E+11
Kenya,KEN,2,4,2,8,1992,Barcelona,ESP,8209129172
Austria,AUT,0,2,0,2,1992,Barcelona,ESP,1.95078E+11
Cuba,CUB,14,6,11,31,1992,Barcelona,ESP,22085858243
Turkey,TUR,2,2,2,6,1992,Barcelona,ESP,1.58459E+11
Poland,POL,3,6,10,19,1992,Barcelona,ESP,94337050693
Czech Republic,CZE,4,2,1,7,1992,Barcelona,ESP,34805013230
Namibia,NAM,0,2,0,2,1992,Barcelona,ESP,3429538518
Lithuania,LTU,1,0,1,2,1992,Barcelona,ESP, $-   
Malaysia,MYS,0,0,1,1,1992,Barcelona,ESP,59167550163
Slovenia,SVN,0,0,2,2,1992,Barcelona,ESP, $-   
Croatia,HRV,0,1,2,3,1992,Barcelona,ESP, $-   
China,CHN,16,22,16,54,1992,Barcelona,ESP,4.26916E+11
United States,USA,37,34,37,108,1992,Barcelona,ESP,6.52033E+12
Spain,ESP,13,7,2,22,1992,Barcelona,ESP,6.30916E+11
Japan,JPN,3,8,11,22,1992,Barcelona,ESP,3.90881E+12
Colombia,COL,0,0,1,1,1992,Barcelona,ESP,58418985443
Unified Team,EUN,45,38,29,112,1992,Barcelona,ESP,
Argentina,ARG,0,0,1,1,1992,Barcelona,ESP,2.28789E+11
New Zealand,NZL,1,4,5,10,1992,Barcelona,ESP,41649829860
Indonesia,IDN,2,2,1,5,1992,Barcelona,ESP,1.28027E+11
Belgium,BEL,0,1,2,3,1992,Barcelona,ESP,2.34782E+11
Italy,ITA,6,5,8,19,1992,Barcelona,ESP,1.32016E+12
Chinese Taipei,TPE,0,1,0,1,1992,Barcelona,ESP,
Israel,ISR,0,1,1,2,1992,Barcelona,ESP, $-   
Pakistan,PAK,0,0,1,1,1992,Barcelona,ESP,48884606848
Peru,PER,0,1,0,1,1992,Barcelona,ESP,35966302303
Individual Olympic Athletes,IOA,0,1,2,3,1992,Barcelona,ESP,
Bulgaria,BGR,3,7,6,16,1992,Barcelona,ESP,10350515464
Nigeria,NGA,0,3,1,4,1992,Barcelona,ESP,47794925815
Norway,NOR,2,4,1,7,1992,Barcelona,ESP,1.30838E+11
Brazil,BRA,2,1,0,3,1992,Barcelona,ESP,4.00599E+11
United Kingdom,GBR,5,3,12,20,1992,Barcelona,ESP,1.17966E+12
North Korea,PRK,4,0,5,9,1992,Barcelona,ESP, $-   
Canada,CAN,7,4,7,18,1992,Barcelona,ESP,5.92388E+11
Sweden,SWE,1,7,4,12,1992,Barcelona,ESP,2.84321E+11
Iran,IRN,0,1,2,3,1992,Barcelona,ESP, $-   
Algeria,DZA,1,0,1,2,1992,Barcelona,ESP,48003078389
Bahamas,BHS,0,0,1,1,1992,Barcelona,ESP,3109000000
Qatar,QAT,0,0,1,1,1992,Barcelona,ESP,7646153984
Ireland,IRL,1,1,0,2,1992,Barcelona,ESP,55927302693
Jamaica,JAM,0,3,1,4,1992,Barcelona,ESP,3535460090
Philippines,PHL,0,0,1,1,1992,Barcelona,ESP,52976344929
Azerbaijan,AZE,0,1,0,1,1996,Atlanta,USA,3176333837
Australia,AUS,9,9,23,41,1996,Atlanta,USA,4.00303E+11
India,IND,0,0,1,1,1996,Atlanta,USA,3.92897E+11
Germany,DEU,20,18,27,65,1996,Atlanta,USA,2.49724E+12
Turkey,TUR,4,1,1,6,1996,Atlanta,USA,1.81476E+11
Greece,GRC,4,4,0,8,1996,Atlanta,USA,1.45862E+11
Denmark,DNK,4,1,1,6,1996,Atlanta,USA,1.87632E+11
Brazil,BRA,3,3,9,15,1996,Atlanta,USA,8.50426E+11
Burundi,BDI,1,0,0,1,1996,Atlanta,USA,869033856.3
Syria,SYR,1,0,0,1,1996,Atlanta,USA,13789560878
Georgia,GEO,0,0,2,2,1996,Atlanta,USA,3095047604
United States,USA,44,32,25,101,1996,Atlanta,USA,8.07312E+12
Czech Republic,CZE,4,3,4,11,1996,Atlanta,USA,67387788633
Ecuador,ECU,1,0,0,1,1996,Atlanta,USA,25226393197
Thailand,THA,1,0,1,2,1996,Atlanta,USA,1.83035E+11
Argentina,ARG,0,2,1,3,1996,Atlanta,USA,2.7215E+11
Bulgaria,BGR,3,7,5,15,1996,Atlanta,USA,12294221473
Ireland,IRL,3,0,1,4,1996,Atlanta,USA,75786499496
China,CHN,16,22,12,50,1996,Atlanta,USA,8.63747E+11
Tonga,TON,0,1,0,1,1996,Atlanta,USA,222100576.3
Cuba,CUB,9,8,8,25,1996,Atlanta,USA,25017368700
Israel,ISR,0,0,1,1,1996,Atlanta,USA,1.10429E+11
Finland,FIN,1,2,1,4,1996,Atlanta,USA,1.32129E+11
Armenia,ARM,1,1,0,2,1996,Atlanta,USA,1596968946
Indonesia,IDN,1,1,2,4,1996,Atlanta,USA,2.2737E+11
Trinidad and Tobago,TTO,0,0,2,2,1996,Atlanta,USA,5759537726
France,FRA,15,7,15,37,1996,Atlanta,USA,1.60568E+12
Italy,ITA,13,10,12,35,1996,Atlanta,USA,1.31243E+12
Algeria,DZA,2,0,1,3,1996,Atlanta,USA,46941582519
Ethiopia,ETH,2,0,1,3,1996,Atlanta,USA,8547939731
United Kingdom,GBR,1,8,6,15,1996,Atlanta,USA,1.41539E+12
Sweden,SWE,2,4,2,8,1996,Atlanta,USA,2.91744E+11
Iran,IRN,1,1,1,3,1996,Atlanta,USA,1.20404E+11
Chinese Taipei,TPE,0,1,0,1,1996,Atlanta,USA,
Canada,CAN,3,11,8,22,1996,Atlanta,USA,6.28546E+11
Costa Rica,CRI,1,0,0,1,1996,Atlanta,USA,11678424512
Zambia,ZMB,0,1,0,1,1996,Atlanta,USA,3597220962
Uzbekistan,UZB,0,1,1,2,1996,Atlanta,USA,13948892216
Uganda,UGA,0,0,1,1,1996,Atlanta,USA,6044585327
Belarus,BLR,1,6,8,15,1996,Atlanta,USA,14756846154
Hong Kong,HKG,1,0,0,1,1996,Atlanta,USA,1.59717E+11
Jamaica,JAM,1,3,2,6,1996,Atlanta,USA,7393883555
Slovakia,SVK,1,1,1,3,1996,Atlanta,USA,27925036755
Morocco,MAR,0,0,2,2,1996,Atlanta,USA,43161452678
Kenya,KEN,1,4,3,8,1996,Atlanta,USA,12045858436
Namibia,NAM,0,2,0,2,1996,Atlanta,USA,3989208671
Spain,ESP,5,6,6,17,1996,Atlanta,USA,6.42589E+11
New Zealand,NZL,3,2,1,6,1996,Atlanta,USA,70140835299
Serbia and Montenegro,SCG,1,1,2,4,1996,Atlanta,USA,
Romania,ROU,4,7,9,20,1996,Atlanta,USA,36937074278
Malaysia,MYS,0,1,1,2,1996,Atlanta,USA,1.00855E+11
Lithuania,LTU,0,0,1,1,1996,Atlanta,USA,8382519637
Puerto Rico,PRI,0,0,1,1,1996,Atlanta,USA,45340835000
Norway,NOR,2,2,3,7,1996,Atlanta,USA,1.6352E+11
Poland,POL,7,5,5,17,1996,Atlanta,USA,1.60193E+11
South Korea,KOR,7,15,5,27,1996,Atlanta,USA,6.1017E+11
Mexico,MEX,0,0,1,1,1996,Atlanta,USA,4.10976E+11
South Africa,ZAF,3,1,1,5,1996,Atlanta,USA,1.47608E+11
Mozambique,MOZ,0,0,1,1,1996,Atlanta,USA,3856799844
Moldova,MDA,0,1,1,2,1996,Atlanta,USA,1695122174
Portugal,PRT,1,0,1,2,1996,Atlanta,USA,1.2263E+11
Ukraine,UKR,9,2,12,23,1996,Atlanta,USA,44558076852
Hungary,HUN,7,4,10,21,1996,Atlanta,USA,46658755152
Tunisia,TUN,0,0,1,1,1996,Atlanta,USA,19587322786
Bahamas,BHS,0,1,0,1,1996,Atlanta,USA,3609000000
Belgium,BEL,2,2,2,6,1996,Atlanta,USA,2.79201E+11
Switzerland,CHE,4,3,0,7,1996,Atlanta,USA,3.40471E+11
Austria,AUT,0,1,2,3,1996,Atlanta,USA,2.37251E+11
Kazakhstan,KAZ,3,4,4,11,1996,Atlanta,USA,21035368251
Croatia,HRV,1,1,0,2,1996,Atlanta,USA,23846613059
Japan,JPN,3,6,5,14,1996,Atlanta,USA,4.83371E+12
Nigeria,NGA,2,1,3,6,1996,Atlanta,USA,51075815093
Mongolia,MNG,0,0,1,1,1996,Atlanta,USA,1345719472
Philippines,PHL,0,1,0,1,1996,Atlanta,USA,82848140618
Slovenia,SVN,0,2,0,2,1996,Atlanta,USA,21507232649
Latvia,LVA,0,1,0,1,1996,Atlanta,USA,5969114344
Russia,RUS,26,21,16,63,1996,Atlanta,USA,3.91725E+11
North Korea,PRK,2,1,2,5,1996,Atlanta,USA, $-   
Netherlands,NLD,4,5,10,19,1996,Atlanta,USA,4.5049E+11
Ireland,IRL,0,1,0,1,2000,Sydney,AUS,99871239174
Algeria,DZA,1,1,3,5,2000,Sydney,AUS,54790379459
Jamaica,JAM,0,6,3,9,2000,Sydney,AUS,9005064475
Qatar,QAT,0,0,1,1,2000,Sydney,AUS,17759890110
Spain,ESP,3,3,5,11,2000,Sydney,AUS,5.96878E+11
Iran,IRN,3,0,1,4,2000,Sydney,AUS,1.09592E+11
Sweden,SWE,4,5,3,12,2000,Sydney,AUS,2.62835E+11
Hungary,HUN,8,6,3,17,2000,Sydney,AUS,47218405892
Indonesia,IDN,1,3,2,6,2000,Sydney,AUS,1.65021E+11
Japan,JPN,5,8,5,18,2000,Sydney,AUS,4.88752E+12
Armenia,ARM,0,0,1,1,2000,Sydney,AUS,1911563669
India,IND,0,0,1,1,2000,Sydney,AUS,4.68395E+11
Australia,AUS,16,25,17,58,2000,Sydney,AUS,4.15223E+11
Kazakhstan,KAZ,3,4,0,7,2000,Sydney,AUS,18291994909
Iceland,ISL,0,0,1,1,2000,Sydney,AUS,9025660362
Israel,ISR,0,0,1,1,2000,Sydney,AUS,1.32705E+11
Argentina,ARG,0,2,2,4,2000,Sydney,AUS,2.84204E+11
Italy,ITA,13,8,13,34,2000,Sydney,AUS,1.14383E+12
France,FRA,13,14,11,38,2000,Sydney,AUS,1.36225E+12
South Korea,KOR,8,10,10,28,2000,Sydney,AUS,5.76178E+11
Portugal,PRT,0,0,2,2,2000,Sydney,AUS,1.18311E+11
Latvia,LVA,1,1,1,3,2000,Sydney,AUS,7949253766
Poland,POL,6,5,3,14,2000,Sydney,AUS,1.72219E+11
Nigeria,NGA,1,2,0,3,2000,Sydney,AUS,69448756933
Georgia,GEO,0,0,6,6,2000,Sydney,AUS,3057475335
Lithuania,LTU,2,0,3,5,2000,Sydney,AUS,11524776867
Azerbaijan,AZE,2,0,1,3,2000,Sydney,AUS,5272798391
Thailand,THA,1,0,2,3,2000,Sydney,AUS,1.26392E+11
Greece,GRC,4,6,3,13,2000,Sydney,AUS,1.30134E+11
Macedonia,MKD,0,0,1,1,2000,Sydney,AUS,3773653058
Bahamas,BHS,2,0,1,3,2000,Sydney,AUS,8076470000
South Africa,ZAF,0,2,3,5,2000,Sydney,AUS,1.36362E+11
Finland,FIN,2,1,1,4,2000,Sydney,AUS,1.25707E+11
Trinidad and Tobago,TTO,0,1,1,2,2000,Sydney,AUS,8154338233
Kyrgyzstan,KGZ,0,0,1,1,2000,Sydney,AUS,1369688498
Romania,ROU,11,6,9,26,2000,Sydney,AUS,37253259017
Kuwait,KWT,0,0,1,1,2000,Sydney,AUS,37712842243
Sri Lanka,LKA,0,1,0,1,2000,Sydney,AUS,16330814180
Switzerland,CHE,1,6,2,9,2000,Sydney,AUS,2.79841E+11
Germany,DEU,13,17,26,56,2000,Sydney,AUS,1.94315E+12
Kenya,KEN,2,3,2,7,2000,Sydney,AUS,12705357103
North Korea,PRK,0,1,3,4,2000,Sydney,AUS, $-   
Colombia,COL,1,0,0,1,2000,Sydney,AUS,99886577331
New Zealand,NZL,1,0,3,4,2000,Sydney,AUS,52623281957
Canada,CAN,3,3,8,14,2000,Sydney,AUS,7.44773E+11
Saudi Arabia,SAU,0,1,1,2,2000,Sydney,AUS,1.89515E+11
Chinese Taipei,TPE,0,1,4,5,2000,Sydney,AUS,
Chile,CHL,0,0,1,1,2000,Sydney,AUS,77860932152
China,CHN,28,16,14,58,2000,Sydney,AUS,1.21135E+12
Morocco,MAR,0,1,4,5,2000,Sydney,AUS,38857251336
Mozambique,MOZ,1,0,0,1,2000,Sydney,AUS,5656473652
Estonia,EST,1,0,2,3,2000,Sydney,AUS,5694069842
Belarus,BLR,3,3,11,17,2000,Sydney,AUS,12738912134
Slovenia,SVN,2,0,0,2,2000,Sydney,AUS,20289627637
Moldova,MDA,0,1,1,2,2000,Sydney,AUS,1288429392
Belgium,BEL,0,2,3,5,2000,Sydney,AUS,2.36205E+11
Vietnam,VNM,0,1,0,1,2000,Sydney,AUS,31172518403
Brazil,BRA,0,6,6,12,2000,Sydney,AUS,6.55421E+11
Russia,RUS,32,28,29,89,2000,Sydney,AUS,2.5971E+11
Ukraine,UKR,3,10,10,23,2000,Sydney,AUS,31261718319
United States,USA,37,24,32,93,2000,Sydney,AUS,1.02523E+13
Croatia,HRV,1,0,1,2,2000,Sydney,AUS,21633759451
Austria,AUT,2,1,0,3,2000,Sydney,AUS,1.968E+11
Mexico,MEX,1,2,3,6,2000,Sydney,AUS,7.07907E+11
Uruguay,URY,0,1,0,1,2000,Sydney,AUS,22823255802
Uzbekistan,UZB,1,1,2,4,2000,Sydney,AUS,13760513969
Barbados,BRB,0,0,1,1,2000,Sydney,AUS,3059500000
Costa Rica,CRI,0,0,2,2,2000,Sydney,AUS,15013629665
Slovakia,SVK,1,3,1,5,2000,Sydney,AUS,29169953013
Norway,NOR,4,3,3,10,2000,Sydney,AUS,1.71247E+11
Denmark,DNK,2,3,1,6,2000,Sydney,AUS,1.64159E+11
Bulgaria,BGR,5,6,2,13,2000,Sydney,AUS,13245833844
Czech Republic,CZE,2,3,3,8,2000,Sydney,AUS,61828166496
Cuba,CUB,11,11,7,29,2000,Sydney,AUS,30565400000
Ethiopia,ETH,4,1,3,8,2000,Sydney,AUS,8242392104
Cameroon,CMR,1,0,0,1,2000,Sydney,AUS,10109045071
Netherlands,NLD,12,9,4,25,2000,Sydney,AUS,4.16443E+11
United Kingdom,GBR,11,10,7,28,2000,Sydney,AUS,1.65819E+12
Serbia and Montenegro,SCG,1,1,1,3,2000,Sydney,AUS,
Turkey,TUR,3,0,2,5,2000,Sydney,AUS,2.74303E+11
Greece,GRC,6,6,4,16,2004,Athens,GRC,2.40521E+11
Trinidad and Tobago,TTO,0,0,1,1,2004,Athens,GRC,13280275123
Switzerland,CHE,1,1,3,5,2004,Athens,GRC,4.05531E+11
Israel,ISR,1,0,1,2,2004,Athens,GRC,1.35728E+11
Iran,IRN,2,2,2,6,2004,Athens,GRC,1.90043E+11
Jamaica,JAM,2,1,2,5,2004,Athens,GRC,10174664854
Spain,ESP,3,11,6,20,2004,Athens,GRC,1.06709E+12
Hong Kong,HKG,0,1,0,1,2004,Athens,GRC,1.691E+11
Indonesia,IDN,1,1,2,4,2004,Athens,GRC,2.56837E+11
Japan,JPN,16,9,12,37,2004,Athens,GRC,4.81515E+12
India,IND,0,1,0,1,2004,Athens,GRC,7.09149E+11
Zimbabwe,ZWE,1,1,1,3,2004,Athens,GRC,5805598400
Kazakhstan,KAZ,1,4,3,8,2004,Athens,GRC,43151647003
Hungary,HUN,8,6,3,17,2004,Athens,GRC,1.0396E+11
Dominican Republic,DOM,1,0,0,1,2004,Athens,GRC,22322395368
Sweden,SWE,4,2,1,7,2004,Athens,GRC,3.85118E+11
Netherlands,NLD,4,9,9,22,2004,Athens,GRC,6.57172E+11
Colombia,COL,0,0,2,2,2004,Athens,GRC,1.17082E+11
Serbia and Montenegro,SCG,0,2,0,2,2004,Athens,GRC,
Slovakia,SVK,2,2,2,6,2004,Athens,GRC,57332015148
China,CHN,32,17,14,63,2004,Athens,GRC,1.95535E+12
Eritrea,ERI,0,0,1,1,2004,Athens,GRC,1109054005
Egypt,EGY,1,1,3,5,2004,Athens,GRC,78782467532
Mongolia,MNG,0,0,1,1,2004,Athens,GRC,1992066808
Chinese Taipei,TPE,2,2,1,5,2004,Athens,GRC,
New Zealand,NZL,3,2,0,5,2004,Athens,GRC,1.03905E+11
United Arab Emirates,ARE,1,0,0,1,2004,Athens,GRC,1.47824E+11
Cuba,CUB,9,7,11,27,2004,Athens,GRC,38203000000
Croatia,HRV,1,2,2,5,2004,Athens,GRC,41587470547
Denmark,DNK,2,1,5,8,2004,Athens,GRC,2.51373E+11
Morocco,MAR,2,1,0,3,2004,Athens,GRC,59626020162
Turkey,TUR,3,3,4,10,2004,Athens,GRC,4.08876E+11
Ukraine,UKR,8,5,9,22,2004,Athens,GRC,64819702952
Czech Republic,CZE,1,3,5,9,2004,Athens,GRC,1.19814E+11
Estonia,EST,0,1,2,3,2004,Athens,GRC,12144397516
Slovenia,SVN,0,1,3,4,2004,Athens,GRC,34414784504
Kenya,KEN,1,4,2,7,2004,Athens,GRC,16095337094
Syria,SYR,0,0,1,1,2004,Athens,GRC,25086930693
North Korea,PRK,0,4,1,5,2004,Athens,GRC, $-   
Argentina,ARG,2,0,4,6,2004,Athens,GRC,1.64658E+11
Norway,NOR,5,0,1,6,2004,Athens,GRC,2.64512E+11
Portugal,PRT,0,2,1,3,2004,Athens,GRC,1.89035E+11
Cameroon,CMR,1,0,0,1,2004,Athens,GRC,17462229589
Belarus,BLR,2,5,6,13,2004,Athens,GRC,23144351852
Paraguay,PRY,0,1,0,1,2004,Athens,GRC,9624440836
Bahamas,BHS,1,0,1,2,2004,Athens,GRC,9055290000
Romania,ROU,8,5,6,19,2004,Athens,GRC,74972669057
Uzbekistan,UZB,2,1,2,5,2004,Athens,GRC,12030023548
Nigeria,NGA,0,0,2,2,2004,Athens,GRC,1.36386E+11
Russia,RUS,28,26,36,90,2004,Athens,GRC,5.91017E+11
Bulgaria,BGR,2,1,9,12,2004,Athens,GRC,26157894737
Poland,POL,3,2,5,10,2004,Athens,GRC,2.5511E+11
South Korea,KOR,9,12,9,30,2004,Athens,GRC,7.93175E+11
United Kingdom,GBR,9,9,12,30,2004,Athens,GRC,2.41205E+12
Azerbaijan,AZE,1,0,4,5,2004,Athens,GRC,8680370408
Canada,CAN,3,6,3,12,2004,Athens,GRC,1.02669E+12
Venezuela,VEN,0,0,2,2,2004,Athens,GRC,1.12453E+11
Latvia,LVA,0,4,0,4,2004,Athens,GRC,14401882399
Austria,AUT,2,4,1,7,2004,Athens,GRC,3.00904E+11
Germany,DEU,13,16,20,49,2004,Athens,GRC,2.80919E+12
Georgia,GEO,2,2,0,4,2004,Athens,GRC,5125365192
Lithuania,LTU,1,2,0,3,2004,Athens,GRC,22627507452
France,FRA,11,9,13,33,2004,Athens,GRC,2.11574E+12
South Africa,ZAF,1,3,2,6,2004,Athens,GRC,2.2859E+11
Chile,CHL,2,0,1,3,2004,Athens,GRC,99210392858
Thailand,THA,3,1,4,8,2004,Athens,GRC,1.72896E+11
Ethiopia,ETH,2,3,2,7,2004,Athens,GRC,10131187261
Brazil,BRA,5,2,3,10,2004,Athens,GRC,6.69317E+11
United States,USA,36,39,26,101,2004,Athens,GRC,1.22137E+13
Belgium,BEL,1,0,2,3,2004,Athens,GRC,3.68537E+11
Australia,AUS,17,16,17,50,2004,Athens,GRC,6.1249E+11
Finland,FIN,0,2,0,2,2004,Athens,GRC,1.97117E+11
Mexico,MEX,0,3,1,4,2004,Athens,GRC,7.82241E+11
Italy,ITA,10,11,11,32,2004,Athens,GRC,1.80323E+12
France,FRA,7,16,20,43,2008,Beijing,CHN,2.91838E+12
Jamaica,JAM,5,4,2,11,2008,Beijing,CHN,13709402085
Egypt,EGY,0,0,2,2,2008,Beijing,CHN,1.62818E+11
Estonia,EST,1,1,0,2,2008,Beijing,CHN,24371299253
Ethiopia,ETH,4,2,1,7,2008,Beijing,CHN,27066912635
Italy,ITA,8,9,10,27,2008,Beijing,CHN,2.39886E+12
Israel,ISR,0,0,1,1,2008,Beijing,CHN,2.16339E+11
Finland,FIN,1,1,2,4,2008,Beijing,CHN,2.84554E+11
Japan,JPN,9,8,8,25,2008,Beijing,CHN,5.03791E+12
Iceland,ISL,0,1,0,1,2008,Beijing,CHN,18074622987
Iran,IRN,1,0,1,2,2008,Beijing,CHN,4.12336E+11
Indonesia,IDN,1,1,4,6,2008,Beijing,CHN,5.10229E+11
Georgia,GEO,3,2,2,7,2008,Beijing,CHN,12795076469
Germany,DEU,16,11,14,41,2008,Beijing,CHN,3.73003E+12
Greece,GRC,0,2,1,3,2008,Beijing,CHN,3.54461E+11
India,IND,1,0,2,3,2008,Beijing,CHN,1.1989E+12
Ecuador,ECU,0,1,0,1,2008,Beijing,CHN,61762635000
Ireland,IRL,0,1,2,3,2008,Beijing,CHN,2.7482E+11
Cameroon,CMR,1,0,0,1,2008,Beijing,CHN,26516681614
Canada,CAN,3,9,8,20,2008,Beijing,CHN,1.55299E+12
Morocco,MAR,0,1,1,2,2008,Beijing,CHN,92507257784
Armenia,ARM,0,1,4,5,2008,Beijing,CHN,11662040714
Dominican Republic,DOM,1,1,0,2,2008,Beijing,CHN,48122547177
Austria,AUT,0,1,2,3,2008,Beijing,CHN,4.30294E+11
Azerbaijan,AZE,1,1,4,6,2008,Beijing,CHN,48852482960
North Korea,PRK,2,2,2,6,2008,Beijing,CHN, $-   
Bulgaria,BGR,1,1,3,5,2008,Beijing,CHN,54438966420
Algeria,DZA,0,1,1,2,2008,Beijing,CHN,1.71001E+11
Brazil,BRA,3,4,10,17,2008,Beijing,CHN,1.69582E+12
Netherlands,NLD,7,5,4,16,2008,Beijing,CHN,9.47998E+11
Australia,AUS,14,15,17,46,2008,Beijing,CHN,1.054E+12
Argentina,ARG,2,0,4,6,2008,Beijing,CHN,3.61558E+11
Bahamas,BHS,0,1,1,2,2008,Beijing,CHN,10526000000
Portugal,PRT,1,1,0,2,2008,Beijing,CHN,2.62345E+11
Belgium,BEL,2,0,0,2,2008,Beijing,CHN,5.15224E+11
Nigeria,NGA,0,3,2,5,2008,Beijing,CHN,3.37036E+11
Panama,PAN,1,0,0,1,2008,Beijing,CHN,25155888600
New Zealand,NZL,3,2,4,9,2008,Beijing,CHN,1.33131E+11
Norway,NOR,3,5,1,9,2008,Beijing,CHN,4.6225E+11
Poland,POL,4,5,2,11,2008,Beijing,CHN,5.33609E+11
Belarus,BLR,3,4,7,14,2008,Beijing,CHN,60763483146
Malaysia,MYS,0,1,0,1,2008,Beijing,CHN,2.30814E+11
Mongolia,MNG,2,2,0,4,2008,Beijing,CHN,5623216449
Latvia,LVA,1,1,1,3,2008,Beijing,CHN,35756225698
Moldova,MDA,0,0,1,1,2008,Beijing,CHN,6054849885
Sudan,SDN,0,1,0,1,2008,Beijing,CHN,54526580232
Singapore,SGP,0,1,0,1,2008,Beijing,CHN,1.93612E+11
Uzbekistan,UZB,0,1,3,4,2008,Beijing,CHN,29549438884
Venezuela,VEN,0,0,1,1,2008,Beijing,CHN,3.15953E+11
Thailand,THA,2,2,2,6,2008,Beijing,CHN,2.91383E+11
Togo,TGO,0,0,1,1,2008,Beijing,CHN,3323677130
Slovakia,SVK,3,3,0,6,2008,Beijing,CHN,1.0047E+11
Slovenia,SVN,1,2,2,5,2008,Beijing,CHN,55552509155
Tajikistan,TJK,0,1,1,2,2008,Beijing,CHN,5161337336
Trinidad and Tobago,TTO,1,1,0,2,2008,Beijing,CHN,27871587350
United Kingdom,GBR,19,13,19,51,2008,Beijing,CHN,2.92143E+12
United States,USA,36,39,37,112,2008,Beijing,CHN,1.47128E+13
Vietnam,VNM,0,1,0,1,2008,Beijing,CHN,99130304099
Samoa,WSM,0,1,0,1,2008,Beijing,CHN,619260721.6
Ukraine,UKR,7,4,11,22,2008,Beijing,CHN,1.79817E+11
Sweden,SWE,0,4,1,5,2008,Beijing,CHN,5.17706E+11
Spain,ESP,5,11,3,19,2008,Beijing,CHN,1.62522E+12
Serbia,SRB,0,1,2,3,2008,Beijing,CHN,52194221469
Switzerland,CHE,2,1,4,7,2008,Beijing,CHN,5.70304E+11
Romania,ROU,4,1,4,9,2008,Beijing,CHN,2.14314E+11
Tunisia,TUN,1,0,0,1,2008,Beijing,CHN,44860969077
Turkey,TUR,1,1,3,5,2008,Beijing,CHN,7.70462E+11
South Korea,KOR,13,11,8,32,2008,Beijing,CHN,1.04734E+12
China,CHN,48,22,30,100,2008,Beijing,CHN,4.59431E+12
Chinese Taipei,TPE,1,1,2,4,2008,Beijing,CHN,
Mexico,MEX,2,0,2,4,2008,Beijing,CHN,1.10999E+12
Mauritius,MUS,0,0,1,1,2008,Beijing,CHN,9990370016
Hungary,HUN,3,5,2,10,2008,Beijing,CHN,1.58136E+11
Croatia,HRV,0,2,3,5,2008,Beijing,CHN,70234425974
Kazakhstan,KAZ,2,3,4,9,2008,Beijing,CHN,1.33442E+11
Lithuania,LTU,0,3,2,5,2008,Beijing,CHN,47797551588
Chile,CHL,0,1,0,1,2008,Beijing,CHN,1.79638E+11
Cuba,CUB,3,10,17,30,2008,Beijing,CHN,60806300000
Kyrgyzstan,KGZ,0,1,2,3,2008,Beijing,CHN,5139957785
South Africa,ZAF,0,1,0,1,2008,Beijing,CHN,2.8677E+11
Russia,RUS,24,13,23,60,2008,Beijing,CHN,1.66085E+12
Afghanistan,AFG,0,0,1,1,2008,Beijing,CHN,10109225814
Colombia,COL,0,2,1,3,2008,Beijing,CHN,2.42187E+11
Denmark,DNK,2,2,3,7,2008,Beijing,CHN,3.53361E+11
Czech Republic,CZE,3,3,1,7,2008,Beijing,CHN,2.36816E+11
Kenya,KEN,6,4,6,16,2008,Beijing,CHN,35895153328
Zimbabwe,ZWE,1,3,0,4,2008,Beijing,CHN,4415702800
Lithuania,LTU,2,0,3,5,2012,London,GBR,42927454291
Latvia,LVA,1,0,1,2,2012,London,GBR,28324787664
Kuwait,KWT,0,0,1,1,2012,London,GBR,1.7407E+11
Netherlands,NLD,6,6,8,20,2012,London,GBR,8.38971E+11
Kenya,KEN,2,4,7,13,2012,London,GBR,50412754861
South Korea,KOR,13,9,8,30,2012,London,GBR,1.27843E+12
Serbia,SRB,1,1,2,4,2012,London,GBR,43309252921
New Zealand,NZL,6,2,5,13,2012,London,GBR,1.76207E+11
Saudi Arabia,SAU,0,0,1,1,2012,London,GBR,7.35975E+11
Japan,JPN,7,14,17,38,2012,London,GBR,6.20321E+12
Slovakia,SVK,0,1,3,4,2012,London,GBR,94534730681
Singapore,SGP,0,0,2,2,2012,London,GBR,2.95087E+11
Spain,ESP,4,10,4,18,2012,London,GBR,1.32482E+12
Russia,RUS,20,20,27,67,2012,London,GBR,2.2083E+12
Germany,DEU,11,20,13,44,2012,London,GBR,3.52734E+12
Qatar,QAT,0,0,2,2,2012,London,GBR,1.86834E+11
Grenada,GRD,1,0,0,1,2012,London,GBR,799882259.3
Kazakhstan,KAZ,3,1,7,11,2012,London,GBR,2.07999E+11
Jamaica,JAM,4,5,3,12,2012,London,GBR,14807086889
Ireland,IRL,1,1,4,6,2012,London,GBR,2.24984E+11
Guatemala,GTM,0,1,0,1,2012,London,GBR,49593961142
Egypt,EGY,0,3,1,4,2012,London,GBR,2.79117E+11
Hong Kong,HKG,0,0,1,1,2012,London,GBR,2.62629E+11
Norway,NOR,2,1,1,4,2012,London,GBR,5.09506E+11
Romania,ROU,2,4,1,7,2012,London,GBR,1.70636E+11
Hungary,HUN,8,4,6,18,2012,London,GBR,1.28475E+11
Puerto Rico,PRI,0,1,1,2,2012,London,GBR,1.01565E+11
Poland,POL,3,2,6,11,2012,London,GBR,4.98524E+11
Iran,IRN,7,5,1,13,2012,London,GBR,5.98868E+11
Portugal,PRT,0,1,0,1,2012,London,GBR,2.16237E+11
Indonesia,IDN,0,2,1,3,2012,London,GBR,9.1787E+11
Sweden,SWE,1,4,3,8,2012,London,GBR,5.52484E+11
India,IND,0,2,4,6,2012,London,GBR,1.82764E+12
Mongolia,MNG,0,2,3,5,2012,London,GBR,12292770631
Italy,ITA,8,9,11,28,2012,London,GBR,2.08708E+12
North Korea,PRK,4,0,2,6,2012,London,GBR, $-   
Mexico,MEX,1,3,4,8,2012,London,GBR,1.20109E+12
Slovenia,SVN,1,1,2,4,2012,London,GBR,46580457470
Montenegro,MNE,0,1,0,1,2012,London,GBR,4087725813
Morocco,MAR,0,0,1,1,2012,London,GBR,98266306615
Malaysia,MYS,0,1,1,2,2012,London,GBR,3.14443E+11
Azerbaijan,AZE,2,2,5,9,2012,London,GBR,69683935845
South Africa,ZAF,4,1,1,6,2012,London,GBR,3.96333E+11
Uzbekistan,UZB,0,0,3,3,2012,London,GBR,63628854499
Vietnam,VNM,0,0,1,1,2012,London,GBR,1.5582E+11
Switzerland,CHE,2,2,0,4,2012,London,GBR,6.9211E+11
Greece,GRC,0,0,2,2,2012,London,GBR,2.42054E+11
Afghanistan,AFG,0,0,1,1,2012,London,GBR,20001598506
Algeria,DZA,1,0,0,1,2012,London,GBR,2.09059E+11
Tajikistan,TJK,0,0,1,1,2012,London,GBR,7633049792
Denmark,DNK,2,4,3,9,2012,London,GBR,3.27149E+11
Argentina,ARG,1,1,2,4,2012,London,GBR,5.45982E+11
Venezuela,VEN,1,0,0,1,2012,London,GBR,3.81286E+11
Gabon,GAB,0,1,0,1,2012,London,GBR,17170465294
Thailand,THA,0,2,2,4,2012,London,GBR,3.97558E+11
Armenia,ARM,0,1,1,2,2012,London,GBR,10619320049
Finland,FIN,0,2,1,3,2012,London,GBR,2.58305E+11
Cameroon,CMR,0,0,1,1,2012,London,GBR,29102772799
Estonia,EST,0,1,1,2,2012,London,GBR,23192708982
Ethiopia,ETH,3,2,3,8,2012,London,GBR,43310721414
Australia,AUS,8,15,12,35,2012,London,GBR,1.54615E+12
Trinidad and Tobago,TTO,1,1,2,4,2012,London,GBR,25763220107
France,FRA,11,11,13,35,2012,London,GBR,2.68383E+12
Dominican Republic,DOM,1,1,0,2,2012,London,GBR,60681537196
Georgia,GEO,1,2,3,6,2012,London,GBR,16488403076
United Kingdom,GBR,29,17,19,65,2012,London,GBR,2.70402E+12
Tunisia,TUN,2,0,1,3,2012,London,GBR,45044138549
Bahamas,BHS,1,0,0,1,2012,London,GBR,10720500000
Cyprus,CYP,0,1,0,1,2012,London,GBR,24978513427
Turkey,TUR,1,1,1,3,2012,London,GBR,8.80556E+11
Cuba,CUB,5,3,7,15,2012,London,GBR,73141000000
Bahrain,BHR,1,0,0,1,2012,London,GBR,30749308511
United States,USA,46,28,30,104,2012,London,GBR,1.6197E+13
Croatia,HRV,3,1,2,6,2012,London,GBR,56580819624
Uganda,UGA,1,0,0,1,2012,London,GBR,27188667093
Czech Republic,CZE,4,3,4,11,2012,London,GBR,2.08858E+11
Colombia,COL,1,3,5,9,2012,London,GBR,3.70921E+11
Belarus,BLR,2,5,3,10,2012,London,GBR,65685102555
Bulgaria,BGR,0,2,1,3,2012,London,GBR,54033250329
Brazil,BRA,3,5,9,17,2012,London,GBR,2.46519E+12
China,CHN,38,31,22,91,2012,London,GBR,8.53223E+12
Canada,CAN,2,5,11,18,2012,London,GBR,1.82837E+12
Chinese Taipei,TPE,1,0,1,2,2012,London,GBR,
Ukraine,UKR,5,4,10,19,2012,London,GBR,1.75781E+11
Belgium,BEL,0,1,2,3,2012,London,GBR,4.96181E+11
Botswana,BWA,0,1,0,1,2012,London,GBR,14380004175
Hungary,HUN,8,3,4,15,2016,Rio de Janeiro,BRA,1.28471E+11
Jamaica,JAM,6,3,2,11,2016,Rio de Janeiro,BRA,14077109397
Spain,ESP,7,4,6,17,2016,Rio de Janeiro,BRA,1.23208E+12
Slovakia,SVK,2,2,0,4,2016,Rio de Janeiro,BRA,89655253976
France,FRA,10,18,14,42,2016,Rio de Janeiro,BRA,2.47129E+12
Greece,GRC,3,1,2,6,2016,Rio de Janeiro,BRA,1.92732E+11
Switzerland,CHE,3,2,2,7,2016,Rio de Janeiro,BRA,6.95601E+11
Germany,DEU,17,10,15,42,2016,Rio de Janeiro,BRA,3.4675E+12
Georgia,GEO,2,1,4,7,2016,Rio de Janeiro,BRA,15141758567
India,IND,0,1,1,2,2016,Rio de Janeiro,BRA,2.2948E+12
Tajikistan,TJK,1,0,0,1,2016,Rio de Janeiro,BRA,6992393787
Sweden,SWE,2,6,3,11,2016,Rio de Janeiro,BRA,5.15655E+11
Individual Olympic Athletes,IOA,1,0,1,2,2016,Rio de Janeiro,BRA,
Indonesia,IDN,1,2,0,3,2016,Rio de Janeiro,BRA,9.31877E+11
Trinidad and Tobago,TTO,0,0,1,1,2016,Rio de Janeiro,BRA,22386264807
Finland,FIN,0,0,1,1,2016,Rio de Janeiro,BRA,2.40608E+11
Iran,IRN,3,1,4,8,2016,Rio de Janeiro,BRA,4.17984E+11
Qatar,QAT,0,1,0,1,2016,Rio de Janeiro,BRA,1.51732E+11
Mexico,MEX,0,3,2,5,2016,Rio de Janeiro,BRA,1.07849E+12
Tunisia,TUN,0,0,3,3,2016,Rio de Janeiro,BRA,41801284916
Slovenia,SVN,1,2,1,4,2016,Rio de Janeiro,BRA,44736333522
Thailand,THA,2,2,2,6,2016,Rio de Janeiro,BRA,4.13366E+11
Dominican Republic,DOM,0,0,1,1,2016,Rio de Janeiro,BRA,75704720190
Japan,JPN,12,8,21,41,2016,Rio de Janeiro,BRA,4.92254E+12
Jordan,JOR,1,0,0,1,2016,Rio de Janeiro,BRA,39892551127
Denmark,DNK,2,6,7,15,2016,Rio de Janeiro,BRA,3.13116E+11
Kazakhstan,KAZ,3,5,10,18,2016,Rio de Janeiro,BRA,1.37278E+11
Czech Republic,CZE,1,2,7,10,2016,Rio de Janeiro,BRA,1.96272E+11
South Korea,KOR,9,3,9,21,2016,Rio de Janeiro,BRA,1.50011E+12
Kenya,KEN,6,6,1,13,2016,Rio de Janeiro,BRA,69188755364
Turkey,TUR,1,3,4,8,2016,Rio de Janeiro,BRA,8.69693E+11
Kosovo,XKX,1,0,0,1,2016,Rio de Janeiro,BRA,6719172017
Egypt,EGY,0,0,3,3,2016,Rio de Janeiro,BRA,3.32442E+11
Croatia,HRV,5,3,2,10,2016,Rio de Janeiro,BRA,51601147666
Lithuania,LTU,0,1,3,4,2016,Rio de Janeiro,BRA,43018087238
Colombia,COL,3,2,3,8,2016,Rio de Janeiro,BRA,2.82825E+11
South Africa,ZAF,2,6,2,10,2016,Rio de Janeiro,BRA,2.96357E+11
Chinese Taipei,TPE,1,0,2,3,2016,Rio de Janeiro,BRA,
Malaysia,MYS,0,4,1,5,2016,Rio de Janeiro,BRA,3.01255E+11
United Arab Emirates,ARE,0,0,1,1,2016,Rio de Janeiro,BRA,3.57045E+11
China,CHN,26,18,26,70,2016,Rio de Janeiro,BRA,1.12333E+13
Ireland,IRL,0,2,0,2,2016,Rio de Janeiro,BRA,2.99556E+11
Norway,NOR,0,0,4,4,2016,Rio de Janeiro,BRA,3.68827E+11
Ethiopia,ETH,1,2,5,8,2016,Rio de Janeiro,BRA,74296618481
Nigeria,NGA,0,0,1,1,2016,Rio de Janeiro,BRA,4.0465E+11
Australia,AUS,8,11,10,29,2016,Rio de Janeiro,BRA,1.20885E+12
Netherlands,NLD,8,7,4,19,2016,Rio de Janeiro,BRA,7.83528E+11
Serbia,SRB,2,4,2,8,2016,Rio de Janeiro,BRA,40692643373
North Korea,PRK,2,3,2,7,2016,Rio de Janeiro,BRA, $-   
Morocco,MAR,0,0,1,1,2016,Rio de Janeiro,BRA,1.03312E+11
Mongolia,MNG,0,1,1,2,2016,Rio de Janeiro,BRA,11186734674
Argentina,ARG,3,1,0,4,2016,Rio de Janeiro,BRA,5.57531E+11
Azerbaijan,AZE,1,7,10,18,2016,Rio de Janeiro,BRA,37867518957
Poland,POL,2,3,6,11,2016,Rio de Janeiro,BRA,4.7263E+11
Brazil,BRA,7,6,6,19,2016,Rio de Janeiro,BRA,1.7957E+12
Singapore,SGP,1,0,0,1,2016,Rio de Janeiro,BRA,3.18764E+11
Burundi,BDI,0,1,0,1,2016,Rio de Janeiro,BRA,2959641047
Algeria,DZA,0,2,0,2,2016,Rio de Janeiro,BRA,1.60034E+11
Portugal,PRT,0,0,1,1,2016,Rio de Janeiro,BRA,2.06286E+11
Bulgaria,BGR,0,1,2,3,2016,Rio de Janeiro,BRA,53806894796
United Kingdom,GBR,27,23,17,67,2016,Rio de Janeiro,BRA,2.69325E+12
Cuba,CUB,5,2,4,11,2016,Rio de Janeiro,BRA,91370000000
Puerto Rico,PRI,1,0,0,1,2016,Rio de Janeiro,BRA,1.04337E+11
Fiji,FJI,1,0,0,1,2016,Rio de Janeiro,BRA,4930204230
Uzbekistan,UZB,4,2,7,13,2016,Rio de Janeiro,BRA,81779012351
Venezuela,VEN,0,2,1,3,2016,Rio de Janeiro,BRA, $-   
Israel,ISR,0,0,2,2,2016,Rio de Janeiro,BRA,3.18617E+11
Estonia,EST,0,0,1,1,2016,Rio de Janeiro,BRA,24259552889
Italy,ITA,8,12,8,28,2016,Rio de Janeiro,BRA,1.8758E+12
Ivory Coast,CIV,1,0,1,2,2016,Rio de Janeiro,BRA,47964234560
Canada,CAN,4,3,15,22,2016,Rio de Janeiro,BRA,1.52799E+12
Grenada,GRD,0,1,0,1,2016,Rio de Janeiro,BRA,1061631222
Niger,NER,0,1,0,1,2016,Rio de Janeiro,BRA,10355006770
Belgium,BEL,2,2,2,6,2016,Rio de Janeiro,BRA,4.7574E+11
Russia,RUS,19,17,20,56,2016,Rio de Janeiro,BRA,1.27679E+12
Austria,AUT,0,0,1,1,2016,Rio de Janeiro,BRA,3.95569E+11
Belarus,BLR,1,4,4,9,2016,Rio de Janeiro,BRA,47722657821
Vietnam,VNM,1,1,0,2,2016,Rio de Janeiro,BRA,2.05276E+11
Romania,ROU,1,1,2,4,2016,Rio de Janeiro,BRA,1.88129E+11
United States,USA,46,37,38,121,2016,Rio de Janeiro,BRA,1.87451E+13
Bahrain,BHR,1,1,0,2,2016,Rio de Janeiro,BRA,32234973404
New Zealand,NZL,4,9,5,18,2016,Rio de Janeiro,BRA,1.88943E+11
Bahamas,BHS,1,0,1,2,2016,Rio de Janeiro,BRA,11928500000
Philippines,PHL,0,1,0,1,2016,Rio de Janeiro,BRA,3.18627E+11
Armenia,ARM,1,3,0,4,2016,Rio de Janeiro,BRA,10546135160
Ukraine,UKR,2,5,4,11,2016,Rio de Janeiro,BRA,93355993629
