Country,Country Code,Gold,Silver,Bronze,Total,Year,Host_City,Host_Country
United States,USA,36,26,28,90,1964,Tokyo,JPN
Soviet Union,URS,30,31,35,96,1964,Tokyo,JPN
Japan,JPN,16,5,8,29,1964,Tokyo,JPN
Germany,GER,10,22,18,50,1964,Tokyo,JPN
Italy,ITA,10,10,7,27,1964,Tokyo,JPN
Hungary,HUN,10,7,5,22,1964,Tokyo,JPN
Poland,POL,7,6,10,23,1964,Tokyo,JPN
Australia,AUS,6,2,10,18,1964,Tokyo,JPN
Czechoslovakia,TCH,5,6,3,14,1964,Tokyo,JPN
Great Britain,GBR,4,12,2,18,1964,Tokyo,JPN
Bulgaria,BUL,3,5,2,10,1964,Tokyo,JPN
Finland,FIN,3,0,2,5,1964,Tokyo,JPN
New Zealand,NZL,3,0,2,5,1964,Tokyo,JPN
Romania,ROU,2,4,6,12,1964,Tokyo,JPN
Netherlands,NED,2,4,4,10,1964,Tokyo,JPN
Turkey,TUR,2,3,1,6,1964,Tokyo,JPN
Sweden,SWE,2,2,4,8,1964,Tokyo,JPN
Denmark,DEN,2,1,3,6,1964,Tokyo,JPN
Yugoslavia,YUG,2,1,2,5,1964,Tokyo,JPN
Belgium,BEL,2,0,1,3,1964,Tokyo,JPN
France,FRA,1,8,6,15,1964,Tokyo,JPN
Canada,CAN,1,2,1,4,1964,Tokyo,JPN
Switzerland,SUI,1,2,1,4,1964,Tokyo,JPN
Ethiopia,ETH,1,0,0,1,1964,Tokyo,JPN
India,IND,1,0,0,1,1964,Tokyo,JPN
The Bahamas,BAH,1,0,0,1,1964,Tokyo,JPN
Republic of Korea,KOR,0,2,1,3,1964,Tokyo,JPN
Trinidad and Tobago,TTO,0,1,2,3,1964,Tokyo,JPN
Tunisia,TUN,0,1,1,2,1964,Tokyo,JPN
Argentina,ARG,0,1,0,1,1964,Tokyo,JPN
Cuba,CUB,0,1,0,1,1964,Tokyo,JPN
Pakistan,PAK,0,1,0,1,1964,Tokyo,JPN
Philippines,PHI,0,1,0,1,1964,Tokyo,JPN
Islamic Republic of Iran,IRI,0,0,2,2,1964,Tokyo,JPN
Brazil,BRA,0,0,1,1,1964,Tokyo,JPN
Ghana,GHA,0,0,1,1,1964,Tokyo,JPN
Ireland,IRL,0,0,1,1,1964,Tokyo,JPN
Kenya,KEN,0,0,1,1,1964,Tokyo,JPN
Mexico,MEX,0,0,1,1,1964,Tokyo,JPN
Nigeria,NGR,0,0,1,1,1964,Tokyo,JPN
Uruguay,URU,0,0,1,1,1964,Tokyo,JPN
United States,USA,45,28,34,107,1968,Mexico City,MEX
Soviet Union,URS,29,32,30,91,1968,Mexico City,MEX
Japan,JPN,11,7,7,25,1968,Mexico City,MEX
Hungary,HUN,10,10,12,32,1968,Mexico City,MEX
East Germany,GDR,9,9,7,25,1968,Mexico City,MEX
France,FRA,7,3,5,15,1968,Mexico City,MEX
Czechoslovakia,TCH,7,2,4,13,1968,Mexico City,MEX
West Germany,FRG,5,11,10,26,1968,Mexico City,MEX
Australia,AUS,5,7,5,17,1968,Mexico City,MEX
Great Britain,GBR,5,5,3,13,1968,Mexico City,MEX
Poland,POL,5,2,11,18,1968,Mexico City,MEX
Romania,ROU,4,6,5,15,1968,Mexico City,MEX
Italy,ITA,3,4,9,16,1968,Mexico City,MEX
Kenya,KEN,3,4,2,9,1968,Mexico City,MEX
Mexico,MEX,3,3,3,9,1968,Mexico City,MEX
Yugoslavia,YUG,3,3,2,8,1968,Mexico City,MEX
Netherlands,NED,3,3,1,7,1968,Mexico City,MEX
Bulgaria,BUL,2,4,3,9,1968,Mexico City,MEX
Islamic Republic of Iran,IRI,2,1,2,5,1968,Mexico City,MEX
Sweden,SWE,2,1,1,4,1968,Mexico City,MEX
Turkey,TUR,2,0,0,2,1968,Mexico City,MEX
Denmark,DEN,1,4,3,8,1968,Mexico City,MEX
Canada,CAN,1,3,1,5,1968,Mexico City,MEX
Finland,FIN,1,2,1,4,1968,Mexico City,MEX
Ethiopia,ETH,1,1,0,2,1968,Mexico City,MEX
Norway,NOR,1,1,0,2,1968,Mexico City,MEX
New Zealand,NZL,1,0,2,3,1968,Mexico City,MEX
Tunisia,TUN,1,0,1,2,1968,Mexico City,MEX
Pakistan,PAK,1,0,0,1,1968,Mexico City,MEX
Venezuela,VEN,1,0,0,1,1968,Mexico City,MEX
Cuba,CUB,0,4,0,4,1968,Mexico City,MEX
Austria,AUT,0,2,2,4,1968,Mexico City,MEX
Switzerland,SUI,0,1,4,5,1968,Mexico City,MEX
Mongolia,MGL,0,1,3,4,1968,Mexico City,MEX
Brazil,BRA,0,1,2,3,1968,Mexico City,MEX
Belgium,BEL,0,1,1,2,1968,Mexico City,MEX
Republic of Korea,KOR,0,1,1,2,1968,Mexico City,MEX
Uganda,UGA,0,1,1,2,1968,Mexico City,MEX
Cameroon,CMR,0,1,0,1,1968,Mexico City,MEX
Jamaica,JAM,0,1,0,1,1968,Mexico City,MEX
Argentina,ARG,0,0,2,2,1968,Mexico City,MEX
Chinese Taipei,TPE,0,0,1,1,1968,Mexico City,MEX
Greece,GRE,0,0,1,1,1968,Mexico City,MEX
India,IND,0,0,1,1,1968,Mexico City,MEX
Soviet Union,URS,50,27,22,99,1972,Munich,GER
United States,USA,33,31,30,94,1972,Munich,GER
East Germany,GDR,20,23,23,66,1972,Munich,GER
West Germany,FRG,13,11,16,40,1972,Munich,GER
Japan,JPN,13,8,8,29,1972,Munich,GER
Australia,AUS,8,7,2,17,1972,Munich,GER
Poland,POL,7,5,9,21,1972,Munich,GER
Hungary,HUN,6,13,16,35,1972,Munich,GER
Bulgaria,BUL,6,10,5,21,1972,Munich,GER
Italy,ITA,5,3,10,18,1972,Munich,GER
Sweden,SWE,4,6,6,16,1972,Munich,GER
Great Britain,GBR,4,5,9,18,1972,Munich,GER
Romania,ROU,3,6,7,16,1972,Munich,GER
Cuba,CUB,3,1,4,8,1972,Munich,GER
Finland,FIN,3,1,4,8,1972,Munich,GER
Netherlands,NED,3,1,1,5,1972,Munich,GER
France,FRA,2,4,7,13,1972,Munich,GER
Czechoslovakia,TCH,2,4,2,8,1972,Munich,GER
Kenya,KEN,2,3,4,9,1972,Munich,GER
Yugoslavia,YUG,2,1,2,5,1972,Munich,GER
Norway,NOR,2,1,1,4,1972,Munich,GER
Democratic People's Republic of Korea,PRK,1,1,3,5,1972,Munich,GER
New Zealand,NZL,1,1,1,3,1972,Munich,GER
Uganda,UGA,1,1,0,2,1972,Munich,GER
Denmark,DEN,1,0,0,1,1972,Munich,GER
Switzerland,SUI,0,3,0,3,1972,Munich,GER
Canada,CAN,0,2,3,5,1972,Munich,GER
Islamic Republic of Iran,IRI,0,2,1,3,1972,Munich,GER
Belgium,BEL,0,2,0,2,1972,Munich,GER
Greece,GRE,0,2,0,2,1972,Munich,GER
Austria,AUT,0,1,2,3,1972,Munich,GER
Colombia,COL,0,1,2,3,1972,Munich,GER
Argentina,ARG,0,1,0,1,1972,Munich,GER
Lebanon,LBN,0,1,0,1,1972,Munich,GER
Mexico,MEX,0,1,0,1,1972,Munich,GER
Mongolia,MGL,0,1,0,1,1972,Munich,GER
Pakistan,PAK,0,1,0,1,1972,Munich,GER
Republic of Korea,KOR,0,1,0,1,1972,Munich,GER
Tunisia,TUN,0,1,0,1,1972,Munich,GER
Turkey,TUR,0,1,0,1,1972,Munich,GER
Brazil,BRA,0,0,2,2,1972,Munich,GER
Ethiopia,ETH,0,0,2,2,1972,Munich,GER
Ghana,GHA,0,0,1,1,1972,Munich,GER
India,IND,0,0,1,1,1972,Munich,GER
Jamaica,JAM,0,0,1,1,1972,Munich,GER
Niger,NIG,0,0,1,1,1972,Munich,GER
Nigeria,NGR,0,0,1,1,1972,Munich,GER
Spain,ESP,0,0,1,1,1972,Munich,GER
Soviet Union,URS,49,41,35,125,1976,Montreal,CAN
East Germany,GDR,40,25,25,90,1976,Montreal,CAN
United States,USA,34,35,25,94,1976,Montreal,CAN
West Germany,FRG,10,12,17,39,1976,Montreal,CAN
Japan,JPN,9,6,10,25,1976,Montreal,CAN
Poland,POL,7,6,13,26,1976,Montreal,CAN
Bulgaria,BUL,6,9,7,22,1976,Montreal,CAN
Cuba,CUB,6,4,3,13,1976,Montreal,CAN
Romania,ROU,4,9,14,27,1976,Montreal,CAN
Hungary,HUN,4,5,13,22,1976,Montreal,CAN
Finland,FIN,4,2,0,6,1976,Montreal,CAN
Sweden,SWE,4,1,0,5,1976,Montreal,CAN
Great Britain,GBR,3,5,5,13,1976,Montreal,CAN
Italy,ITA,2,7,4,13,1976,Montreal,CAN
France,FRA,2,3,4,9,1976,Montreal,CAN
Yugoslavia,YUG,2,3,3,8,1976,Montreal,CAN
Czechoslovakia,TCH,2,2,4,8,1976,Montreal,CAN
New Zealand,NZL,2,1,1,4,1976,Montreal,CAN
Republic of Korea,KOR,1,1,4,6,1976,Montreal,CAN
Switzerland,SUI,1,1,2,4,1976,Montreal,CAN
Democratic People's Republic of Korea,PRK,1,1,0,2,1976,Montreal,CAN
Jamaica,JAM,1,1,0,2,1976,Montreal,CAN
Norway,NOR,1,1,0,2,1976,Montreal,CAN
Denmark,DEN,1,0,2,3,1976,Montreal,CAN
Mexico,MEX,1,0,1,2,1976,Montreal,CAN
Trinidad and Tobago,TTO,1,0,0,1,1976,Montreal,CAN
Canada,CAN,0,5,6,11,1976,Montreal,CAN
Belgium,BEL,0,3,3,6,1976,Montreal,CAN
Netherlands,NED,0,2,3,5,1976,Montreal,CAN
Portugal,POR,0,2,0,2,1976,Montreal,CAN
Spain,ESP,0,2,0,2,1976,Montreal,CAN
Australia,AUS,0,1,4,5,1976,Montreal,CAN
Islamic Republic of Iran,IRI,0,1,1,2,1976,Montreal,CAN
Mongolia,MGL,0,1,0,1,1976,Montreal,CAN
Venezuela,VEN,0,1,0,1,1976,Montreal,CAN
Brazil,BRA,0,0,2,2,1976,Montreal,CAN
Austria,AUT,0,0,1,1,1976,Montreal,CAN
Bermuda,BER,0,0,1,1,1976,Montreal,CAN
Pakistan,PAK,0,0,1,1,1976,Montreal,CAN
Puerto Rico,PUR,0,0,1,1,1976,Montreal,CAN
Thailand,THA,0,0,1,1,1976,Montreal,CAN
Soviet Union,URS,80,69,46,195,1980,Moskow,RUS
East Germany,GDR,47,37,42,126,1980,Moskow,RUS
Bulgaria,BUL,8,16,17,41,1980,Moskow,RUS
Cuba,CUB,8,7,5,20,1980,Moskow,RUS
Italy,ITA,8,3,4,15,1980,Moskow,RUS
Hungary,HUN,7,10,15,32,1980,Moskow,RUS
Romania,ROU,6,6,13,25,1980,Moskow,RUS
France,FRA,6,5,3,14,1980,Moskow,RUS
Great Britain,GBR,5,7,9,21,1980,Moskow,RUS
Poland,POL,3,14,15,32,1980,Moskow,RUS
Sweden,SWE,3,3,6,12,1980,Moskow,RUS
Finland,FIN,3,1,4,8,1980,Moskow,RUS
Czechoslovakia,TCH,2,3,9,14,1980,Moskow,RUS
Yugoslavia,YUG,2,3,4,9,1980,Moskow,RUS
Australia,AUS,2,2,5,9,1980,Moskow,RUS
Denmark,DEN,2,1,2,5,1980,Moskow,RUS
Brazil,BRA,2,0,2,4,1980,Moskow,RUS
Ethiopia,ETH,2,0,2,4,1980,Moskow,RUS
Switzerland,SUI,2,0,0,2,1980,Moskow,RUS
Spain,ESP,1,3,2,6,1980,Moskow,RUS
Austria,AUT,1,2,1,4,1980,Moskow,RUS
Greece,GRE,1,0,2,3,1980,Moskow,RUS
Belgium,BEL,1,0,0,1,1980,Moskow,RUS
India,IND,1,0,0,1,1980,Moskow,RUS
Zimbabwe,ZIM,1,0,0,1,1980,Moskow,RUS
Democratic People's Republic of Korea,PRK,0,3,2,5,1980,Moskow,RUS
Mongolia,MGL,0,2,2,4,1980,Moskow,RUS
United Republic of Tanzania,TAN,0,2,0,2,1980,Moskow,RUS
Mexico,MEX,0,1,3,4,1980,Moskow,RUS
Netherlands,NED,0,1,2,3,1980,Moskow,RUS
Ireland,IRL,0,1,1,2,1980,Moskow,RUS
Uganda,UGA,0,1,0,1,1980,Moskow,RUS
Venezuela,VEN,0,1,0,1,1980,Moskow,RUS
Jamaica,JAM,0,0,3,3,1980,Moskow,RUS
Guyana,GUY,0,0,1,1,1980,Moskow,RUS
Lebanon,LBN,0,0,1,1,1980,Moskow,RUS
United States,USA,83,61,30,174,1984,Los Angeles,USA
Romania,ROU,20,16,17,53,1984,Los Angeles,USA
West Germany,FRG,17,19,23,59,1984,Los Angeles,USA
People's Republic of China,CHN,15,8,9,32,1984,Los Angeles,USA
Italy,ITA,14,6,12,32,1984,Los Angeles,USA
Canada,CAN,10,18,16,44,1984,Los Angeles,USA
Japan,JPN,10,8,14,32,1984,Los Angeles,USA
New Zealand,NZL,8,1,2,11,1984,Los Angeles,USA
Yugoslavia,YUG,7,4,7,18,1984,Los Angeles,USA
Republic of Korea,KOR,6,6,7,19,1984,Los Angeles,USA
Great Britain,GBR,5,11,21,37,1984,Los Angeles,USA
France,FRA,5,7,16,28,1984,Los Angeles,USA
Netherlands,NED,5,2,6,13,1984,Los Angeles,USA
Australia,AUS,4,8,12,24,1984,Los Angeles,USA
Finland,FIN,4,2,6,12,1984,Los Angeles,USA
Sweden,SWE,2,11,6,19,1984,Los Angeles,USA
Mexico,MEX,2,3,1,6,1984,Los Angeles,USA
Morocco,MAR,2,0,0,2,1984,Los Angeles,USA
Brazil,BRA,1,5,2,8,1984,Los Angeles,USA
Spain,ESP,1,2,2,5,1984,Los Angeles,USA
Belgium,BEL,1,1,2,4,1984,Los Angeles,USA
Austria,AUT,1,1,1,3,1984,Los Angeles,USA
Kenya,KEN,1,0,2,3,1984,Los Angeles,USA
Portugal,POR,1,0,2,3,1984,Los Angeles,USA
Pakistan,PAK,1,0,0,1,1984,Los Angeles,USA
Switzerland,SUI,0,4,4,8,1984,Los Angeles,USA
Denmark,DEN,0,3,3,6,1984,Los Angeles,USA
Jamaica,JAM,0,1,2,3,1984,Los Angeles,USA
Norway,NOR,0,1,2,3,1984,Los Angeles,USA
Greece,GRE,0,1,1,2,1984,Los Angeles,USA
Nigeria,NGR,0,1,1,2,1984,Los Angeles,USA
Puerto Rico,PUR,0,1,1,2,1984,Los Angeles,USA
Colombia,COL,0,1,0,1,1984,Los Angeles,USA
CÃ´te d'Ivoire,CIV,0,1,0,1,1984,Los Angeles,USA
Egypt,EGY,0,1,0,1,1984,Los Angeles,USA
Ireland,IRL,0,1,0,1,1984,Los Angeles,USA
Peru,PER,0,1,0,1,1984,Los Angeles,USA
Syrian Arab Republic,SYR,0,1,0,1,1984,Los Angeles,USA
Thailand,THA,0,1,0,1,1984,Los Angeles,USA
Turkey,TUR,0,0,3,3,1984,Los Angeles,USA
Venezuela,VEN,0,0,3,3,1984,Los Angeles,USA
Algeria,ALG,0,0,2,2,1984,Los Angeles,USA
Cameroon,CMR,0,0,1,1,1984,Los Angeles,USA
Chinese Taipei,TPE,0,0,1,1,1984,Los Angeles,USA
Dominican Republic,DOM,0,0,1,1,1984,Los Angeles,USA
Iceland,ISL,0,0,1,1,1984,Los Angeles,USA
Zambia,ZAM,0,0,1,1,1984,Los Angeles,USA
Soviet Union,URS,55,31,46,132,1988,Seoul,KOR
East Germany,GDR,37,35,30,102,1988,Seoul,KOR
United States,USA,36,31,27,94,1988,Seoul,KOR
Republic of Korea,KOR,12,10,11,33,1988,Seoul,KOR
West Germany,FRG,11,14,15,40,1988,Seoul,KOR
Hungary,HUN,11,6,6,23,1988,Seoul,KOR
Bulgaria,BUL,10,12,13,35,1988,Seoul,KOR
Romania,ROU,7,11,6,24,1988,Seoul,KOR
France,FRA,6,4,6,16,1988,Seoul,KOR
Italy,ITA,6,4,4,14,1988,Seoul,KOR
People's Republic of China,CHN,5,11,12,28,1988,Seoul,KOR
Great Britain,GBR,5,10,9,24,1988,Seoul,KOR
Kenya,KEN,5,2,2,9,1988,Seoul,KOR
Japan,JPN,4,3,7,14,1988,Seoul,KOR
Australia,AUS,3,6,5,14,1988,Seoul,KOR
Yugoslavia,YUG,3,4,5,12,1988,Seoul,KOR
Czechoslovakia,TCH,3,3,2,8,1988,Seoul,KOR
New Zealand,NZL,3,2,8,13,1988,Seoul,KOR
Canada,CAN,3,2,5,10,1988,Seoul,KOR
Poland,POL,2,5,9,16,1988,Seoul,KOR
Norway,NOR,2,3,0,5,1988,Seoul,KOR
Netherlands,NED,2,2,5,9,1988,Seoul,KOR
Denmark,DEN,2,1,1,4,1988,Seoul,KOR
Brazil,BRA,1,2,3,6,1988,Seoul,KOR
Finland,FIN,1,1,2,4,1988,Seoul,KOR
Spain,ESP,1,1,2,4,1988,Seoul,KOR
Turkey,TUR,1,1,0,2,1988,Seoul,KOR
Morocco,MAR,1,0,2,3,1988,Seoul,KOR
Austria,AUT,1,0,0,1,1988,Seoul,KOR
Portugal,POR,1,0,0,1,1988,Seoul,KOR
Suriname,SUR,1,0,0,1,1988,Seoul,KOR
Sweden,SWE,0,4,7,11,1988,Seoul,KOR
Switzerland,SUI,0,2,2,4,1988,Seoul,KOR
Jamaica,JAM,0,2,0,2,1988,Seoul,KOR
Argentina,ARG,0,1,1,2,1988,Seoul,KOR
Chile,CHI,0,1,0,1,1988,Seoul,KOR
Costa Rica,CRC,0,1,0,1,1988,Seoul,KOR
Indonesia,INA,0,1,0,1,1988,Seoul,KOR
Islamic Republic of Iran,IRI,0,1,0,1,1988,Seoul,KOR
Netherlands Antilles,AHO,0,1,0,1,1988,Seoul,KOR
Peru,PER,0,1,0,1,1988,Seoul,KOR
Senegal,SEN,0,1,0,1,1988,Seoul,KOR
United States Virgin Islands,ISV,0,1,0,1,1988,Seoul,KOR
Belgium,BEL,0,0,2,2,1988,Seoul,KOR
Mexico,MEX,0,0,2,2,1988,Seoul,KOR
Colombia,COL,0,0,1,1,1988,Seoul,KOR
Djibouti,DJI,0,0,1,1,1988,Seoul,KOR
Greece,GRE,0,0,1,1,1988,Seoul,KOR
Mongolia,MGL,0,0,1,1,1988,Seoul,KOR
Pakistan,PAK,0,0,1,1,1988,Seoul,KOR
Philippines,PHI,0,0,1,1,1988,Seoul,KOR
Thailand,THA,0,0,1,1,1988,Seoul,KOR
Unified Team,EUN,45,38,29,112,1992,Barcelona,ESP
United States,USA,37,34,37,108,1992,Barcelona,ESP
Germany,GER,33,21,28,82,1992,Barcelona,ESP
People's Republic of China,CHN,16,22,16,54,1992,Barcelona,ESP
Cuba,CUB,14,6,11,31,1992,Barcelona,ESP
Spain,ESP,13,7,2,22,1992,Barcelona,ESP
Republic of Korea,KOR,12,5,12,29,1992,Barcelona,ESP
Hungary,HUN,11,12,7,30,1992,Barcelona,ESP
France,FRA,8,5,16,29,1992,Barcelona,ESP
Australia,AUS,7,9,11,27,1992,Barcelona,ESP
Canada,CAN,7,4,7,18,1992,Barcelona,ESP
Italy,ITA,6,5,8,19,1992,Barcelona,ESP
Great Britain,GBR,5,3,12,20,1992,Barcelona,ESP
Romania,ROU,4,6,8,18,1992,Barcelona,ESP
Czechoslovakia,TCH,4,2,1,7,1992,Barcelona,ESP
Democratic People's Republic of Korea,PRK,4,0,5,9,1992,Barcelona,ESP
Japan,JPN,3,8,11,22,1992,Barcelona,ESP
Bulgaria,BUL,3,7,6,16,1992,Barcelona,ESP
Poland,POL,3,6,10,19,1992,Barcelona,ESP
Netherlands,NED,2,6,7,15,1992,Barcelona,ESP
Kenya,KEN,2,4,2,8,1992,Barcelona,ESP
Norway,NOR,2,4,1,7,1992,Barcelona,ESP
Turkey,TUR,2,2,2,6,1992,Barcelona,ESP
Indonesia,INA,2,2,1,5,1992,Barcelona,ESP
Brazil,BRA,2,1,0,3,1992,Barcelona,ESP
Greece,GRE,2,0,0,2,1992,Barcelona,ESP
Sweden,SWE,1,7,4,12,1992,Barcelona,ESP
New Zealand,NZL,1,4,5,10,1992,Barcelona,ESP
Finland,FIN,1,2,2,5,1992,Barcelona,ESP
Denmark,DEN,1,1,4,6,1992,Barcelona,ESP
Morocco,MAR,1,1,1,3,1992,Barcelona,ESP
Ireland,IRL,1,1,0,2,1992,Barcelona,ESP
Ethiopia,ETH,1,0,2,3,1992,Barcelona,ESP
Algeria,ALG,1,0,1,2,1992,Barcelona,ESP
Estonia,EST,1,0,1,2,1992,Barcelona,ESP
Lithuania,LTU,1,0,1,2,1992,Barcelona,ESP
Switzerland,SUI,1,0,0,1,1992,Barcelona,ESP
Jamaica,JAM,0,3,1,4,1992,Barcelona,ESP
Nigeria,NGR,0,3,1,4,1992,Barcelona,ESP
Latvia,LAT,0,2,1,3,1992,Barcelona,ESP
Austria,AUT,0,2,0,2,1992,Barcelona,ESP
Namibia,NAM,0,2,0,2,1992,Barcelona,ESP
South Africa,RSA,0,2,0,2,1992,Barcelona,ESP
Belgium,BEL,0,1,2,3,1992,Barcelona,ESP
Croatia,CRO,0,1,2,3,1992,Barcelona,ESP
Individual Olympic Athletes,IOA,0,1,2,3,1992,Barcelona,ESP
Islamic Republic of Iran,IRI,0,1,2,3,1992,Barcelona,ESP
Israel,ISR,0,1,1,2,1992,Barcelona,ESP
Chinese Taipei,TPE,0,1,0,1,1992,Barcelona,ESP
Mexico,MEX,0,1,0,1,1992,Barcelona,ESP
Peru,PER,0,1,0,1,1992,Barcelona,ESP
Mongolia,MGL,0,0,2,2,1992,Barcelona,ESP
Slovenia,SLO,0,0,2,2,1992,Barcelona,ESP
Argentina,ARG,0,0,1,1,1992,Barcelona,ESP
Colombia,COL,0,0,1,1,1992,Barcelona,ESP
Ghana,GHA,0,0,1,1,1992,Barcelona,ESP
Malaysia,MAS,0,0,1,1,1992,Barcelona,ESP
Pakistan,PAK,0,0,1,1,1992,Barcelona,ESP
Philippines,PHI,0,0,1,1,1992,Barcelona,ESP
Puerto Rico,PUR,0,0,1,1,1992,Barcelona,ESP
Qatar,QAT,0,0,1,1,1992,Barcelona,ESP
Suriname,SUR,0,0,1,1,1992,Barcelona,ESP
Thailand,THA,0,0,1,1,1992,Barcelona,ESP
The Bahamas,BAH,0,0,1,1,1992,Barcelona,ESP
United States,USA,44,32,25,101,1996,Atlanta,USA
Russian Federation,RUS,26,21,16,63,1996,Atlanta,USA
Germany,GER,20,18,27,65,1996,Atlanta,USA
People's Republic of China,CHN,16,22,12,50,1996,Atlanta,USA
France,FRA,15,7,15,37,1996,Atlanta,USA
Italy,ITA,13,10,12,35,1996,Atlanta,USA
Australia,AUS,9,9,23,41,1996,Atlanta,USA
Cuba,CUB,9,8,8,25,1996,Atlanta,USA
Ukraine,UKR,9,2,12,23,1996,Atlanta,USA
Republic of Korea,KOR,7,15,5,27,1996,Atlanta,USA
Poland,POL,7,5,5,17,1996,Atlanta,USA
Hungary,HUN,7,4,10,21,1996,Atlanta,USA
Spain,ESP,5,6,6,17,1996,Atlanta,USA
Romania,ROU,4,7,9,20,1996,Atlanta,USA
Netherlands,NED,4,5,10,19,1996,Atlanta,USA
Greece,GRE,4,4,0,8,1996,Atlanta,USA
Czech Republic,CZE,4,3,4,11,1996,Atlanta,USA
Switzerland,SUI,4,3,0,7,1996,Atlanta,USA
Denmark,DEN,4,1,1,6,1996,Atlanta,USA
Turkey,TUR,4,1,1,6,1996,Atlanta,USA
Canada,CAN,3,11,8,22,1996,Atlanta,USA
Bulgaria,BUL,3,7,5,15,1996,Atlanta,USA
Japan,JPN,3,6,5,14,1996,Atlanta,USA
Kazakhstan,KAZ,3,4,4,11,1996,Atlanta,USA
Brazil,BRA,3,3,9,15,1996,Atlanta,USA
New Zealand,NZL,3,2,1,6,1996,Atlanta,USA
South Africa,RSA,3,1,1,5,1996,Atlanta,USA
Ireland,IRL,3,0,1,4,1996,Atlanta,USA
Sweden,SWE,2,4,2,8,1996,Atlanta,USA
Norway,NOR,2,2,3,7,1996,Atlanta,USA
Belgium,BEL,2,2,2,6,1996,Atlanta,USA
Nigeria,NGR,2,1,3,6,1996,Atlanta,USA
Democratic People's Republic of Korea,PRK,2,1,2,5,1996,Atlanta,USA
Algeria,ALG,2,0,1,3,1996,Atlanta,USA
Ethiopia,ETH,2,0,1,3,1996,Atlanta,USA
Great Britain,GBR,1,8,6,15,1996,Atlanta,USA
Belarus,BLR,1,6,8,15,1996,Atlanta,USA
Kenya,KEN,1,4,3,8,1996,Atlanta,USA
Jamaica,JAM,1,3,2,6,1996,Atlanta,USA
Finland,FIN,1,2,1,4,1996,Atlanta,USA
Indonesia,INA,1,1,2,4,1996,Atlanta,USA
Serbia and Montenegro,SCG,1,1,2,4,1996,Atlanta,USA
Islamic Republic of Iran,IRI,1,1,1,3,1996,Atlanta,USA
Slovakia,SVK,1,1,1,3,1996,Atlanta,USA
Armenia,ARM,1,1,0,2,1996,Atlanta,USA
Croatia,CRO,1,1,0,2,1996,Atlanta,USA
Portugal,POR,1,0,1,2,1996,Atlanta,USA
Thailand,THA,1,0,1,2,1996,Atlanta,USA
Burundi,BDI,1,0,0,1,1996,Atlanta,USA
Costa Rica,CRC,1,0,0,1,1996,Atlanta,USA
Ecuador,ECU,1,0,0,1,1996,Atlanta,USA
"Hong Kong, China",HKG,1,0,0,1,1996,Atlanta,USA
Syrian Arab Republic,SYR,1,0,0,1,1996,Atlanta,USA
Argentina,ARG,0,2,1,3,1996,Atlanta,USA
Namibia,NAM,0,2,0,2,1996,Atlanta,USA
Slovenia,SLO,0,2,0,2,1996,Atlanta,USA
Austria,AUT,0,1,2,3,1996,Atlanta,USA
Malaysia,MAS,0,1,1,2,1996,Atlanta,USA
Republic of Moldova,MDA,0,1,1,2,1996,Atlanta,USA
Uzbekistan,UZB,0,1,1,2,1996,Atlanta,USA
Azerbaijan,AZE,0,1,0,1,1996,Atlanta,USA
Chinese Taipei,TPE,0,1,0,1,1996,Atlanta,USA
Latvia,LAT,0,1,0,1,1996,Atlanta,USA
Philippines,PHI,0,1,0,1,1996,Atlanta,USA
The Bahamas,BAH,0,1,0,1,1996,Atlanta,USA
Tonga,TGA,0,1,0,1,1996,Atlanta,USA
Zambia,ZAM,0,1,0,1,1996,Atlanta,USA
Georgia,GEO,0,0,2,2,1996,Atlanta,USA
Morocco,MAR,0,0,2,2,1996,Atlanta,USA
Trinidad and Tobago,TTO,0,0,2,2,1996,Atlanta,USA
India,IND,0,0,1,1,1996,Atlanta,USA
Israel,ISR,0,0,1,1,1996,Atlanta,USA
Lithuania,LTU,0,0,1,1,1996,Atlanta,USA
Mexico,MEX,0,0,1,1,1996,Atlanta,USA
Mongolia,MGL,0,0,1,1,1996,Atlanta,USA
Mozambique,MOZ,0,0,1,1,1996,Atlanta,USA
Puerto Rico,PUR,0,0,1,1,1996,Atlanta,USA
Tunisia,TUN,0,0,1,1,1996,Atlanta,USA
Uganda,UGA,0,0,1,1,1996,Atlanta,USA
United States,USA,37,24,32,93,2000,Sydney,AUS
Russian Federation,RUS,32,28,29,89,2000,Sydney,AUS
People's Republic of China,CHN,28,16,14,58,2000,Sydney,AUS
Australia,AUS,16,25,17,58,2000,Sydney,AUS
Germany,GER,13,17,26,56,2000,Sydney,AUS
France,FRA,13,14,11,38,2000,Sydney,AUS
Italy,ITA,13,8,13,34,2000,Sydney,AUS
Netherlands,NED,12,9,4,25,2000,Sydney,AUS
Cuba,CUB,11,11,7,29,2000,Sydney,AUS
Great Britain,GBR,11,10,7,28,2000,Sydney,AUS
Romania,ROU,11,6,9,26,2000,Sydney,AUS
Republic of Korea,KOR,8,10,10,28,2000,Sydney,AUS
Hungary,HUN,8,6,3,17,2000,Sydney,AUS
Poland,POL,6,5,3,14,2000,Sydney,AUS
Japan,JPN,5,8,5,18,2000,Sydney,AUS
Bulgaria,BUL,5,6,2,13,2000,Sydney,AUS
Greece,GRE,4,6,3,13,2000,Sydney,AUS
Sweden,SWE,4,5,3,12,2000,Sydney,AUS
Norway,NOR,4,3,3,10,2000,Sydney,AUS
Ethiopia,ETH,4,1,3,8,2000,Sydney,AUS
Ukraine,UKR,3,10,10,23,2000,Sydney,AUS
Kazakhstan,KAZ,3,4,0,7,2000,Sydney,AUS
Belarus,BLR,3,3,11,17,2000,Sydney,AUS
Canada,CAN,3,3,8,14,2000,Sydney,AUS
Spain,ESP,3,3,5,11,2000,Sydney,AUS
Turkey,TUR,3,0,2,5,2000,Sydney,AUS
Islamic Republic of Iran,IRI,3,0,1,4,2000,Sydney,AUS
Czech Republic,CZE,2,3,3,8,2000,Sydney,AUS
Kenya,KEN,2,3,2,7,2000,Sydney,AUS
Denmark,DEN,2,3,1,6,2000,Sydney,AUS
Finland,FIN,2,1,1,4,2000,Sydney,AUS
Austria,AUT,2,1,0,3,2000,Sydney,AUS
Lithuania,LTU,2,0,3,5,2000,Sydney,AUS
Azerbaijan,AZE,2,0,1,3,2000,Sydney,AUS
The Bahamas,BAH,2,0,1,3,2000,Sydney,AUS
Slovenia,SLO,2,0,0,2,2000,Sydney,AUS
Switzerland,SUI,1,6,2,9,2000,Sydney,AUS
Indonesia,INA,1,3,2,6,2000,Sydney,AUS
Slovakia,SVK,1,3,1,5,2000,Sydney,AUS
Mexico,MEX,1,2,3,6,2000,Sydney,AUS
Nigeria,NGR,1,2,0,3,2000,Sydney,AUS
Algeria,ALG,1,1,3,5,2000,Sydney,AUS
Uzbekistan,UZB,1,1,2,4,2000,Sydney,AUS
Latvia,LAT,1,1,1,3,2000,Sydney,AUS
Serbia and Montenegro,SCG,1,1,1,3,2000,Sydney,AUS
New Zealand,NZL,1,0,3,4,2000,Sydney,AUS
Estonia,EST,1,0,2,3,2000,Sydney,AUS
Thailand,THA,1,0,2,3,2000,Sydney,AUS
Croatia,CRO,1,0,1,2,2000,Sydney,AUS
Cameroon,CMR,1,0,0,1,2000,Sydney,AUS
Colombia,COL,1,0,0,1,2000,Sydney,AUS
Mozambique,MOZ,1,0,0,1,2000,Sydney,AUS
Brazil,BRA,0,6,6,12,2000,Sydney,AUS
Jamaica,JAM,0,6,3,9,2000,Sydney,AUS
Belgium,BEL,0,2,3,5,2000,Sydney,AUS
South Africa,RSA,0,2,3,5,2000,Sydney,AUS
Argentina,ARG,0,2,2,4,2000,Sydney,AUS
Chinese Taipei,TPE,0,1,4,5,2000,Sydney,AUS
Morocco,MAR,0,1,4,5,2000,Sydney,AUS
Democratic People's Republic of Korea,PRK,0,1,3,4,2000,Sydney,AUS
Kingdom of Saudi Arabia,KSA,0,1,1,2,2000,Sydney,AUS
Republic of Moldova,MDA,0,1,1,2,2000,Sydney,AUS
Trinidad and Tobago,TTO,0,1,1,2,2000,Sydney,AUS
Ireland,IRL,0,1,0,1,2000,Sydney,AUS
Sri Lanka,SRI,0,1,0,1,2000,Sydney,AUS
Uruguay,URU,0,1,0,1,2000,Sydney,AUS
Vietnam,VIE,0,1,0,1,2000,Sydney,AUS
Georgia,GEO,0,0,6,6,2000,Sydney,AUS
Costa Rica,CRC,0,0,2,2,2000,Sydney,AUS
Portugal,POR,0,0,2,2,2000,Sydney,AUS
Armenia,ARM,0,0,1,1,2000,Sydney,AUS
Barbados,BAR,0,0,1,1,2000,Sydney,AUS
Chile,CHI,0,0,1,1,2000,Sydney,AUS
Iceland,ISL,0,0,1,1,2000,Sydney,AUS
India,IND,0,0,1,1,2000,Sydney,AUS
Israel,ISR,0,0,1,1,2000,Sydney,AUS
Kuwait,KUW,0,0,1,1,2000,Sydney,AUS
Kyrgyzstan,KGZ,0,0,1,1,2000,Sydney,AUS
North Macedonia,MKD,0,0,1,1,2000,Sydney,AUS
Qatar,QAT,0,0,1,1,2000,Sydney,AUS
United States,USA,36,39,26,101,2004,Athens,GRC
People's Republic of China,CHN,32,17,14,63,2004,Athens,GRC
Russian Federation,RUS,28,26,36,90,2004,Athens,GRC
Australia,AUS,17,16,17,50,2004,Athens,GRC
Japan,JPN,16,9,12,37,2004,Athens,GRC
Germany,GER,13,16,20,49,2004,Athens,GRC
France,FRA,11,9,13,33,2004,Athens,GRC
Italy,ITA,10,11,11,32,2004,Athens,GRC
Republic of Korea,KOR,9,12,9,30,2004,Athens,GRC
Great Britain,GBR,9,9,12,30,2004,Athens,GRC
Cuba,CUB,9,7,11,27,2004,Athens,GRC
Hungary,HUN,8,6,3,17,2004,Athens,GRC
Ukraine,UKR,8,5,9,22,2004,Athens,GRC
Romania,ROU,8,5,6,19,2004,Athens,GRC
Greece,GRE,6,6,4,16,2004,Athens,GRC
Brazil,BRA,5,2,3,10,2004,Athens,GRC
Norway,NOR,5,0,1,6,2004,Athens,GRC
Netherlands,NED,4,9,9,22,2004,Athens,GRC
Sweden,SWE,4,2,1,7,2004,Athens,GRC
Spain,ESP,3,11,6,20,2004,Athens,GRC
Canada,CAN,3,6,3,12,2004,Athens,GRC
Turkey,TUR,3,3,4,10,2004,Athens,GRC
Poland,POL,3,2,5,10,2004,Athens,GRC
New Zealand,NZL,3,2,0,5,2004,Athens,GRC
Thailand,THA,3,1,4,8,2004,Athens,GRC
Belarus,BLR,2,5,6,13,2004,Athens,GRC
Austria,AUT,2,4,1,7,2004,Athens,GRC
Ethiopia,ETH,2,3,2,7,2004,Athens,GRC
Islamic Republic of Iran,IRI,2,2,2,6,2004,Athens,GRC
Slovakia,SVK,2,2,2,6,2004,Athens,GRC
Chinese Taipei,TPE,2,2,1,5,2004,Athens,GRC
Georgia,GEO,2,2,0,4,2004,Athens,GRC
Bulgaria,BUL,2,1,9,12,2004,Athens,GRC
Denmark,DEN,2,1,5,8,2004,Athens,GRC
Jamaica,JAM,2,1,2,5,2004,Athens,GRC
Uzbekistan,UZB,2,1,2,5,2004,Athens,GRC
Morocco,MAR,2,1,0,3,2004,Athens,GRC
Argentina,ARG,2,0,4,6,2004,Athens,GRC
Chile,CHI,2,0,1,3,2004,Athens,GRC
Kazakhstan,KAZ,1,4,3,8,2004,Athens,GRC
Kenya,KEN,1,4,2,7,2004,Athens,GRC
Czech Republic,CZE,1,3,5,9,2004,Athens,GRC
South Africa,RSA,1,3,2,6,2004,Athens,GRC
Croatia,CRO,1,2,2,5,2004,Athens,GRC
Lithuania,LTU,1,2,0,3,2004,Athens,GRC
Egypt,EGY,1,1,3,5,2004,Athens,GRC
Switzerland,SUI,1,1,3,5,2004,Athens,GRC
Indonesia,INA,1,1,2,4,2004,Athens,GRC
Zimbabwe,ZIM,1,1,1,3,2004,Athens,GRC
Azerbaijan,AZE,1,0,4,5,2004,Athens,GRC
Belgium,BEL,1,0,2,3,2004,Athens,GRC
Israel,ISR,1,0,1,2,2004,Athens,GRC
The Bahamas,BAH,1,0,1,2,2004,Athens,GRC
Cameroon,CMR,1,0,0,1,2004,Athens,GRC
Dominican Republic,DOM,1,0,0,1,2004,Athens,GRC
United Arab Emirates,UAE,1,0,0,1,2004,Athens,GRC
Democratic People's Republic of Korea,PRK,0,4,1,5,2004,Athens,GRC
Latvia,LAT,0,4,0,4,2004,Athens,GRC
Mexico,MEX,0,3,1,4,2004,Athens,GRC
Portugal,POR,0,2,1,3,2004,Athens,GRC
Finland,FIN,0,2,0,2,2004,Athens,GRC
Serbia and Montenegro,SCG,0,2,0,2,2004,Athens,GRC
Slovenia,SLO,0,1,3,4,2004,Athens,GRC
Estonia,EST,0,1,2,3,2004,Athens,GRC
"Hong Kong, China",HKG,0,1,0,1,2004,Athens,GRC
India,IND,0,1,0,1,2004,Athens,GRC
Paraguay,PAR,0,1,0,1,2004,Athens,GRC
Colombia,COL,0,0,2,2,2004,Athens,GRC
Nigeria,NGR,0,0,2,2,2004,Athens,GRC
Venezuela,VEN,0,0,2,2,2004,Athens,GRC
Eritrea,ERI,0,0,1,1,2004,Athens,GRC
Mongolia,MGL,0,0,1,1,2004,Athens,GRC
Syrian Arab Republic,SYR,0,0,1,1,2004,Athens,GRC
Trinidad and Tobago,TTO,0,0,1,1,2004,Athens,GRC
People's Republic of China,CHN,48,22,30,100,2008,Beijing,CHN
United States,USA,36,39,37,112,2008,Beijing,CHN
Russian Federation,RUS,24,13,23,60,2008,Beijing,CHN
Great Britain,GBR,19,13,19,51,2008,Beijing,CHN
Germany,GER,16,11,14,41,2008,Beijing,CHN
Australia,AUS,14,15,17,46,2008,Beijing,CHN
Republic of Korea,KOR,13,11,8,32,2008,Beijing,CHN
Japan,JPN,9,8,8,25,2008,Beijing,CHN
Italy,ITA,8,9,10,27,2008,Beijing,CHN
France,FRA,7,16,20,43,2008,Beijing,CHN
Netherlands,NED,7,5,4,16,2008,Beijing,CHN
Ukraine,UKR,7,4,11,22,2008,Beijing,CHN
Kenya,KEN,6,4,6,16,2008,Beijing,CHN
Spain,ESP,5,11,3,19,2008,Beijing,CHN
Jamaica,JAM,5,4,2,11,2008,Beijing,CHN
Poland,POL,4,5,2,11,2008,Beijing,CHN
Ethiopia,ETH,4,2,1,7,2008,Beijing,CHN
Romania,ROU,4,1,4,9,2008,Beijing,CHN
Cuba,CUB,3,10,17,30,2008,Beijing,CHN
Canada,CAN,3,9,8,20,2008,Beijing,CHN
Hungary,HUN,3,5,2,10,2008,Beijing,CHN
Norway,NOR,3,5,1,9,2008,Beijing,CHN
Brazil,BRA,3,4,10,17,2008,Beijing,CHN
Belarus,BLR,3,4,7,14,2008,Beijing,CHN
Czech Republic,CZE,3,3,1,7,2008,Beijing,CHN
Slovakia,SVK,3,3,0,6,2008,Beijing,CHN
New Zealand,NZL,3,2,4,9,2008,Beijing,CHN
Georgia,GEO,3,2,2,7,2008,Beijing,CHN
Kazakhstan,KAZ,2,3,4,9,2008,Beijing,CHN
Denmark,DEN,2,2,3,7,2008,Beijing,CHN
Democratic People's Republic of Korea,PRK,2,2,2,6,2008,Beijing,CHN
Thailand,THA,2,2,2,6,2008,Beijing,CHN
Mongolia,MGL,2,2,0,4,2008,Beijing,CHN
Switzerland,SUI,2,1,4,7,2008,Beijing,CHN
Argentina,ARG,2,0,4,6,2008,Beijing,CHN
Mexico,MEX,2,0,2,4,2008,Beijing,CHN
Belgium,BEL,2,0,0,2,2008,Beijing,CHN
Zimbabwe,ZIM,1,3,0,4,2008,Beijing,CHN
Slovenia,SLO,1,2,2,5,2008,Beijing,CHN
Azerbaijan,AZE,1,1,4,6,2008,Beijing,CHN
Indonesia,INA,1,1,4,6,2008,Beijing,CHN
Bulgaria,BUL,1,1,3,5,2008,Beijing,CHN
Turkey,TUR,1,1,3,5,2008,Beijing,CHN
Chinese Taipei,TPE,1,1,2,4,2008,Beijing,CHN
Finland,FIN,1,1,2,4,2008,Beijing,CHN
Latvia,LAT,1,1,1,3,2008,Beijing,CHN
Dominican Republic,DOM,1,1,0,2,2008,Beijing,CHN
Estonia,EST,1,1,0,2,2008,Beijing,CHN
Portugal,POR,1,1,0,2,2008,Beijing,CHN
Trinidad and Tobago,TTO,1,1,0,2,2008,Beijing,CHN
India,IND,1,0,2,3,2008,Beijing,CHN
Islamic Republic of Iran,IRI,1,0,1,2,2008,Beijing,CHN
Cameroon,CMR,1,0,0,1,2008,Beijing,CHN
Panama,PAN,1,0,0,1,2008,Beijing,CHN
Tunisia,TUN,1,0,0,1,2008,Beijing,CHN
Sweden,SWE,0,4,1,5,2008,Beijing,CHN
Lithuania,LTU,0,3,2,5,2008,Beijing,CHN
Nigeria,NGR,0,3,2,5,2008,Beijing,CHN
Croatia,CRO,0,2,3,5,2008,Beijing,CHN
Colombia,COL,0,2,1,3,2008,Beijing,CHN
Greece,GRE,0,2,1,3,2008,Beijing,CHN
Armenia,ARM,0,1,4,5,2008,Beijing,CHN
Uzbekistan,UZB,0,1,3,4,2008,Beijing,CHN
Austria,AUT,0,1,2,3,2008,Beijing,CHN
Ireland,IRL,0,1,2,3,2008,Beijing,CHN
Kyrgyzstan,KGZ,0,1,2,3,2008,Beijing,CHN
Serbia,SRB,0,1,2,3,2008,Beijing,CHN
Algeria,ALG,0,1,1,2,2008,Beijing,CHN
Morocco,MAR,0,1,1,2,2008,Beijing,CHN
Tajikistan,TJK,0,1,1,2,2008,Beijing,CHN
The Bahamas,BAH,0,1,1,2,2008,Beijing,CHN
Chile,CHI,0,1,0,1,2008,Beijing,CHN
Ecuador,ECU,0,1,0,1,2008,Beijing,CHN
Iceland,ISL,0,1,0,1,2008,Beijing,CHN
Malaysia,MAS,0,1,0,1,2008,Beijing,CHN
Samoa,SAM,0,1,0,1,2008,Beijing,CHN
Singapore,SGP,0,1,0,1,2008,Beijing,CHN
South Africa,RSA,0,1,0,1,2008,Beijing,CHN
Sudan,SUD,0,1,0,1,2008,Beijing,CHN
Vietnam,VIE,0,1,0,1,2008,Beijing,CHN
Egypt,EGY,0,0,2,2,2008,Beijing,CHN
Afghanistan,AFG,0,0,1,1,2008,Beijing,CHN
Israel,ISR,0,0,1,1,2008,Beijing,CHN
Mauritius,MRI,0,0,1,1,2008,Beijing,CHN
Republic of Moldova,MDA,0,0,1,1,2008,Beijing,CHN
Togo,TOG,0,0,1,1,2008,Beijing,CHN
Venezuela,VEN,0,0,1,1,2008,Beijing,CHN
United States,USA,46,28,30,104,2012,London,GBR
People's Republic of China,CHN,38,31,22,91,2012,London,GBR
Great Britain,GBR,29,17,19,65,2012,London,GBR
Russian Federation,RUS,20,20,27,67,2012,London,GBR
Republic of Korea,KOR,13,9,8,30,2012,London,GBR
Germany,GER,11,20,13,44,2012,London,GBR
France,FRA,11,11,13,35,2012,London,GBR
Australia,AUS,8,15,12,35,2012,London,GBR
Italy,ITA,8,9,11,28,2012,London,GBR
Hungary,HUN,8,4,6,18,2012,London,GBR
Japan,JPN,7,14,17,38,2012,London,GBR
Islamic Republic of Iran,IRI,7,5,1,13,2012,London,GBR
Netherlands,NED,6,6,8,20,2012,London,GBR
New Zealand,NZL,6,2,5,13,2012,London,GBR
Ukraine,UKR,5,4,10,19,2012,London,GBR
Cuba,CUB,5,3,7,15,2012,London,GBR
Spain,ESP,4,10,4,18,2012,London,GBR
Jamaica,JAM,4,5,3,12,2012,London,GBR
Czech Republic,CZE,4,3,4,11,2012,London,GBR
South Africa,RSA,4,1,1,6,2012,London,GBR
Democratic People's Republic of Korea,PRK,4,0,2,6,2012,London,GBR
Brazil,BRA,3,5,9,17,2012,London,GBR
Poland,POL,3,2,6,11,2012,London,GBR
Ethiopia,ETH,3,2,3,8,2012,London,GBR
Kazakhstan,KAZ,3,1,7,11,2012,London,GBR
Croatia,CRO,3,1,2,6,2012,London,GBR
Canada,CAN,2,5,11,18,2012,London,GBR
Belarus,BLR,2,5,3,10,2012,London,GBR
Kenya,KEN,2,4,7,13,2012,London,GBR
Denmark,DEN,2,4,3,9,2012,London,GBR
Romania,ROU,2,4,1,7,2012,London,GBR
Azerbaijan,AZE,2,2,5,9,2012,London,GBR
Switzerland,SUI,2,2,0,4,2012,London,GBR
Norway,NOR,2,1,1,4,2012,London,GBR
Lithuania,LTU,2,0,3,5,2012,London,GBR
Tunisia,TUN,2,0,1,3,2012,London,GBR
Sweden,SWE,1,4,3,8,2012,London,GBR
Colombia,COL,1,3,5,9,2012,London,GBR
Mexico,MEX,1,3,4,8,2012,London,GBR
Georgia,GEO,1,2,3,6,2012,London,GBR
Ireland,IRL,1,1,4,6,2012,London,GBR
Argentina,ARG,1,1,2,4,2012,London,GBR
Serbia,SRB,1,1,2,4,2012,London,GBR
Slovenia,SLO,1,1,2,4,2012,London,GBR
Trinidad and Tobago,TTO,1,1,2,4,2012,London,GBR
Turkey,TUR,1,1,1,3,2012,London,GBR
Dominican Republic,DOM,1,1,0,2,2012,London,GBR
Chinese Taipei,TPE,1,0,1,2,2012,London,GBR
Latvia,LAT,1,0,1,2,2012,London,GBR
Algeria,ALG,1,0,0,1,2012,London,GBR
Bahrain,BRN,1,0,0,1,2012,London,GBR
Grenada,GRN,1,0,0,1,2012,London,GBR
The Bahamas,BAH,1,0,0,1,2012,London,GBR
Uganda,UGA,1,0,0,1,2012,London,GBR
Venezuela,VEN,1,0,0,1,2012,London,GBR
Egypt,EGY,0,3,1,4,2012,London,GBR
India,IND,0,2,4,6,2012,London,GBR
Mongolia,MGL,0,2,3,5,2012,London,GBR
Thailand,THA,0,2,2,4,2012,London,GBR
Bulgaria,BUL,0,2,1,3,2012,London,GBR
Finland,FIN,0,2,1,3,2012,London,GBR
Indonesia,INA,0,2,1,3,2012,London,GBR
Slovakia,SVK,0,1,3,4,2012,London,GBR
Belgium,BEL,0,1,2,3,2012,London,GBR
Armenia,ARM,0,1,1,2,2012,London,GBR
Estonia,EST,0,1,1,2,2012,London,GBR
Malaysia,MAS,0,1,1,2,2012,London,GBR
Puerto Rico,PUR,0,1,1,2,2012,London,GBR
Botswana,BOT,0,1,0,1,2012,London,GBR
Cyprus,CYP,0,1,0,1,2012,London,GBR
Gabon,GAB,0,1,0,1,2012,London,GBR
Guatemala,GUA,0,1,0,1,2012,London,GBR
Montenegro,MNE,0,1,0,1,2012,London,GBR
Portugal,POR,0,1,0,1,2012,London,GBR
Uzbekistan,UZB,0,0,3,3,2012,London,GBR
Greece,GRE,0,0,2,2,2012,London,GBR
Qatar,QAT,0,0,2,2,2012,London,GBR
Singapore,SGP,0,0,2,2,2012,London,GBR
Afghanistan,AFG,0,0,1,1,2012,London,GBR
Cameroon,CMR,0,0,1,1,2012,London,GBR
"Hong Kong, China",HKG,0,0,1,1,2012,London,GBR
Kingdom of Saudi Arabia,KSA,0,0,1,1,2012,London,GBR
Kuwait,KUW,0,0,1,1,2012,London,GBR
Morocco,MAR,0,0,1,1,2012,London,GBR
Tajikistan,TJK,0,0,1,1,2012,London,GBR
Vietnam,VIE,0,0,1,1,2012,London,GBR
United States,USA,46,37,38,121,2016,Rio de Janeiro,BRA
Great Britain,GBR,27,23,17,67,2016,Rio de Janeiro,BRA
People's Republic of China,CHN,26,18,26,70,2016,Rio de Janeiro,BRA
Russian Federation,RUS,19,17,20,56,2016,Rio de Janeiro,BRA
Germany,GER,17,10,15,42,2016,Rio de Janeiro,BRA
Japan,JPN,12,8,21,41,2016,Rio de Janeiro,BRA
France,FRA,10,18,14,42,2016,Rio de Janeiro,BRA
Republic of Korea,KOR,9,3,9,21,2016,Rio de Janeiro,BRA
Italy,ITA,8,12,8,28,2016,Rio de Janeiro,BRA
Australia,AUS,8,11,10,29,2016,Rio de Janeiro,BRA
Netherlands,NED,8,7,4,19,2016,Rio de Janeiro,BRA
Hungary,HUN,8,3,4,15,2016,Rio de Janeiro,BRA
Brazil,BRA,7,6,6,19,2016,Rio de Janeiro,BRA
Spain,ESP,7,4,6,17,2016,Rio de Janeiro,BRA
Kenya,KEN,6,6,1,13,2016,Rio de Janeiro,BRA
Jamaica,JAM,6,3,2,11,2016,Rio de Janeiro,BRA
Croatia,CRO,5,3,2,10,2016,Rio de Janeiro,BRA
Cuba,CUB,5,2,4,11,2016,Rio de Janeiro,BRA
New Zealand,NZL,4,9,5,18,2016,Rio de Janeiro,BRA
Canada,CAN,4,3,15,22,2016,Rio de Janeiro,BRA
Uzbekistan,UZB,4,2,7,13,2016,Rio de Janeiro,BRA
Kazakhstan,KAZ,3,5,10,18,2016,Rio de Janeiro,BRA
Colombia,COL,3,2,3,8,2016,Rio de Janeiro,BRA
Switzerland,SUI,3,2,2,7,2016,Rio de Janeiro,BRA
Islamic Republic of Iran,IRI,3,1,4,8,2016,Rio de Janeiro,BRA
Greece,GRE,3,1,2,6,2016,Rio de Janeiro,BRA
Argentina,ARG,3,1,0,4,2016,Rio de Janeiro,BRA
Denmark,DEN,2,6,7,15,2016,Rio de Janeiro,BRA
Sweden,SWE,2,6,3,11,2016,Rio de Janeiro,BRA
South Africa,RSA,2,6,2,10,2016,Rio de Janeiro,BRA
Ukraine,UKR,2,5,4,11,2016,Rio de Janeiro,BRA
Serbia,SRB,2,4,2,8,2016,Rio de Janeiro,BRA
Poland,POL,2,3,6,11,2016,Rio de Janeiro,BRA
Democratic People's Republic of Korea,PRK,2,3,2,7,2016,Rio de Janeiro,BRA
Belgium,BEL,2,2,2,6,2016,Rio de Janeiro,BRA
Thailand,THA,2,2,2,6,2016,Rio de Janeiro,BRA
Slovakia,SVK,2,2,0,4,2016,Rio de Janeiro,BRA
Georgia,GEO,2,1,4,7,2016,Rio de Janeiro,BRA
Azerbaijan,AZE,1,7,10,18,2016,Rio de Janeiro,BRA
Belarus,BLR,1,4,4,9,2016,Rio de Janeiro,BRA
Turkey,TUR,1,3,4,8,2016,Rio de Janeiro,BRA
Armenia,ARM,1,3,0,4,2016,Rio de Janeiro,BRA
Czech Republic,CZE,1,2,7,10,2016,Rio de Janeiro,BRA
Ethiopia,ETH,1,2,5,8,2016,Rio de Janeiro,BRA
Slovenia,SLO,1,2,1,4,2016,Rio de Janeiro,BRA
Indonesia,INA,1,2,0,3,2016,Rio de Janeiro,BRA
Romania,ROU,1,1,2,4,2016,Rio de Janeiro,BRA
Bahrain,BRN,1,1,0,2,2016,Rio de Janeiro,BRA
Vietnam,VIE,1,1,0,2,2016,Rio de Janeiro,BRA
Chinese Taipei,TPE,1,0,2,3,2016,Rio de Janeiro,BRA
CÃ´te d'Ivoire,CIV,1,0,1,2,2016,Rio de Janeiro,BRA
Individual Olympic Athletes,IOA,1,0,1,2,2016,Rio de Janeiro,BRA
The Bahamas,BAH,1,0,1,2,2016,Rio de Janeiro,BRA
Fiji,FIJ,1,0,0,1,2016,Rio de Janeiro,BRA
Jordan,JOR,1,0,0,1,2016,Rio de Janeiro,BRA
Kosovo,KOS,1,0,0,1,2016,Rio de Janeiro,BRA
Puerto Rico,PUR,1,0,0,1,2016,Rio de Janeiro,BRA
Singapore,SGP,1,0,0,1,2016,Rio de Janeiro,BRA
Tajikistan,TJK,1,0,0,1,2016,Rio de Janeiro,BRA
Malaysia,MAS,0,4,1,5,2016,Rio de Janeiro,BRA
Mexico,MEX,0,3,2,5,2016,Rio de Janeiro,BRA
Venezuela,VEN,0,2,1,3,2016,Rio de Janeiro,BRA
Algeria,ALG,0,2,0,2,2016,Rio de Janeiro,BRA
Ireland,IRL,0,2,0,2,2016,Rio de Janeiro,BRA
Lithuania,LTU,0,1,3,4,2016,Rio de Janeiro,BRA
Bulgaria,BUL,0,1,2,3,2016,Rio de Janeiro,BRA
India,IND,0,1,1,2,2016,Rio de Janeiro,BRA
Mongolia,MGL,0,1,1,2,2016,Rio de Janeiro,BRA
Burundi,BDI,0,1,0,1,2016,Rio de Janeiro,BRA
Grenada,GRN,0,1,0,1,2016,Rio de Janeiro,BRA
Niger,NIG,0,1,0,1,2016,Rio de Janeiro,BRA
Philippines,PHI,0,1,0,1,2016,Rio de Janeiro,BRA
Qatar,QAT,0,1,0,1,2016,Rio de Janeiro,BRA
Norway,NOR,0,0,4,4,2016,Rio de Janeiro,BRA
Egypt,EGY,0,0,3,3,2016,Rio de Janeiro,BRA
Tunisia,TUN,0,0,3,3,2016,Rio de Janeiro,BRA
Israel,ISR,0,0,2,2,2016,Rio de Janeiro,BRA
Austria,AUT,0,0,1,1,2016,Rio de Janeiro,BRA
Dominican Republic,DOM,0,0,1,1,2016,Rio de Janeiro,BRA
Estonia,EST,0,0,1,1,2016,Rio de Janeiro,BRA
Finland,FIN,0,0,1,1,2016,Rio de Janeiro,BRA
Morocco,MAR,0,0,1,1,2016,Rio de Janeiro,BRA
Nigeria,NGR,0,0,1,1,2016,Rio de Janeiro,BRA
Portugal,POR,0,0,1,1,2016,Rio de Janeiro,BRA
Trinidad and Tobago,TTO,0,0,1,1,2016,Rio de Janeiro,BRA
United Arab Emirates,UAE,0,0,1,1,2016,Rio de Janeiro,BRA
