Country,Country Code,Gold,Silver,Bronze,Total,Year,Host_City,Host_Country,GDP (USD Mil)
Netherlands,NLD,2,4,4,10,1964,Tokyo,JPN,
Bulgaria,BGR,3,5,2,10,1964,Tokyo,JPN,
Pakistan,PAK,0,1,0,1,1964,Tokyo,JPN,
Brazil,BRA,0,0,1,1,1964,Tokyo,JPN,
Italy,ITA,10,10,7,27,1964,Tokyo,JPN,
Sweden,SWE,2,2,4,8,1964,Tokyo,JPN,24401.202
Uruguay,URY,0,0,1,1,1964,Tokyo,JPN,
Ireland,IRL,0,0,1,1,1964,Tokyo,JPN,
Japan,JPN,16,5,8,29,1964,Tokyo,JPN,
Iran,IRN,0,0,2,2,1964,Tokyo,JPN,
Cuba,CUB,0,1,0,1,1964,Tokyo,JPN,
Switzerland,CHE,1,2,1,4,1964,Tokyo,JPN,
India,IND,1,0,0,1,1964,Tokyo,JPN,
Kenya,KEN,0,0,1,1,1964,Tokyo,JPN,
Philippines,PHL,0,1,0,1,1964,Tokyo,JPN,
Hungary,HUN,10,7,5,22,1964,Tokyo,JPN,
United States,USA,36,26,28,90,1964,Tokyo,JPN,
Romania,ROU,2,4,6,12,1964,Tokyo,JPN,
Yugoslavia,YUG,2,1,2,5,1964,Tokyo,JPN,
Ghana,GHA,0,0,1,1,1964,Tokyo,JPN,
Argentina,ARG,0,1,0,1,1964,Tokyo,JPN,
New Zealand,NZL,3,0,2,5,1964,Tokyo,JPN,
Czech Republic,CZE,5,6,3,14,1964,Tokyo,JPN,
Australia,AUS,6,2,10,18,1964,Tokyo,JPN,32694.467
Russia,RUS,30,31,35,96,1964,Tokyo,JPN,
Germany,DEU,10,22,18,50,1964,Tokyo,JPN,
Poland,POL,7,6,10,23,1964,Tokyo,JPN,
South Korea,KOR,0,2,1,3,1964,Tokyo,JPN,
France,FRA,1,8,6,15,1964,Tokyo,JPN,113249.46
Mexico,MEX,0,0,1,1,1964,Tokyo,JPN,
Finland,FIN,3,0,2,5,1964,Tokyo,JPN,
Canada,CAN,1,2,1,4,1964,Tokyo,JPN,56477.8
Trinidad and Tobago,TTO,0,1,2,3,1964,Tokyo,JPN,
United Kingdom,GBR,4,12,2,18,1964,Tokyo,JPN,138405.51
Nigeria,NGA,0,0,1,1,1964,Tokyo,JPN,
Turkey,TUR,2,3,1,6,1964,Tokyo,JPN,
Tunisia,TUN,0,1,1,2,1964,Tokyo,JPN,
Denmark,DNK,2,1,3,6,1964,Tokyo,JPN,
Ethiopia,ETH,1,0,0,1,1964,Tokyo,JPN,
Belgium,BEL,2,0,1,3,1964,Tokyo,JPN,
Bahamas,BHS,1,0,0,1,1964,Tokyo,JPN,
Czech Republic,CZE,7,2,4,13,1968,Mexico City,MEX,
France,FRA,7,3,5,15,1968,Mexico City,MEX,157794.703
Mexico,MEX,3,3,3,9,1968,Mexico City,MEX,
Finland,FIN,1,2,1,4,1968,Mexico City,MEX,
Mongolia,MNG,0,1,3,4,1968,Mexico City,MEX,
Tunisia,TUN,1,0,1,2,1968,Mexico City,MEX,
Turkey,TUR,2,0,0,2,1968,Mexico City,MEX,
Denmark,DNK,1,4,3,8,1968,Mexico City,MEX,19448.084
Netherlands,NLD,3,3,1,7,1968,Mexico City,MEX,
Germany,DEU,9,9,7,25,1968,Mexico City,MEX,
Poland,POL,5,2,11,18,1968,Mexico City,MEX,
Romania,ROU,4,6,5,15,1968,Mexico City,MEX,
Venezuela,VEN,1,0,0,1,1968,Mexico City,MEX,
Argentina,ARG,0,0,2,2,1968,Mexico City,MEX,
Russia,RUS,29,32,30,91,1968,Mexico City,MEX,
Belgium,BEL,0,1,1,2,1968,Mexico City,MEX,
Australia,AUS,5,7,5,17,1968,Mexico City,MEX,46488.435
Austria,AUT,0,2,2,4,1968,Mexico City,MEX,
Yugoslavia,YUG,3,3,2,8,1968,Mexico City,MEX,
South Korea,KOR,0,1,1,2,1968,Mexico City,MEX,
Pakistan,PAK,1,0,0,1,1968,Mexico City,MEX,
Germany,DEU,5,11,10,26,1968,Mexico City,MEX,
Sweden,SWE,2,1,1,4,1968,Mexico City,MEX,31794.557
Greece,GRC,0,0,1,1,1968,Mexico City,MEX,20016.157
Cuba,CUB,0,4,0,4,1968,Mexico City,MEX,
United Kingdom,GBR,5,5,3,13,1968,Mexico City,MEX,180450.377
Cameroon,CMR,0,1,0,1,1968,Mexico City,MEX,
Bulgaria,BGR,2,4,3,9,1968,Mexico City,MEX,
Brazil,BRA,0,1,2,3,1968,Mexico City,MEX,
United States,USA,45,28,34,107,1968,Mexico City,MEX,
New Zealand,NZL,1,0,2,3,1968,Mexico City,MEX,
Canada,CAN,1,3,1,5,1968,Mexico City,MEX,80115.42
Norway,NOR,1,1,0,2,1968,Mexico City,MEX,
Ethiopia,ETH,1,1,0,2,1968,Mexico City,MEX,
Chinese Taipei,TPE,0,0,1,1,1968,Mexico City,MEX,
Jamaica,JAM,0,1,0,1,1968,Mexico City,MEX,
Italy,ITA,3,4,9,16,1968,Mexico City,MEX,
Japan,JPN,11,7,7,25,1968,Mexico City,MEX,
Iran,IRN,2,1,2,5,1968,Mexico City,MEX,
Switzerland,CHE,0,1,4,5,1968,Mexico City,MEX,
India,IND,0,0,1,1,1968,Mexico City,MEX,
Hungary,HUN,10,10,12,32,1968,Mexico City,MEX,
Uganda,UGA,0,1,1,2,1968,Mexico City,MEX,
Kenya,KEN,3,4,2,9,1968,Mexico City,MEX,
Pakistan,PAK,0,1,0,1,1972,Munich,DEU,
Germany,DEU,20,23,23,66,1972,Munich,DEU,369740.5
Uganda,UGA,1,1,0,2,1972,Munich,DEU,
Norway,NOR,2,1,1,4,1972,Munich,DEU,15873.192
Turkey,TUR,0,1,0,1,1972,Munich,DEU,77952.83
Yugoslavia,YUG,2,1,2,5,1972,Munich,DEU,
Niger,NER,0,0,1,1,1972,Munich,DEU,
United States,USA,33,31,30,94,1972,Munich,DEU,1279110
Ghana,GHA,0,0,1,1,1972,Munich,DEU,
Denmark,DNK,1,0,0,1,1972,Munich,DEU,24557.097
Jamaica,JAM,0,0,1,1,1972,Munich,DEU,
France,FRA,2,4,7,13,1972,Munich,DEU,230914.012
Romania,ROU,3,6,7,16,1972,Munich,DEU,
Finland,FIN,3,1,4,8,1972,Munich,DEU,18790.37
Mexico,MEX,0,1,0,1,1972,Munich,DEU,116543.715
Sweden,SWE,4,6,6,16,1972,Munich,DEU,44547.788
Brazil,BRA,0,0,2,2,1972,Munich,DEU,
Russia,RUS,50,27,22,99,1972,Munich,DEU,
Italy,ITA,5,3,10,18,1972,Munich,DEU,225680.458
South Korea,KOR,0,1,0,1,1972,Munich,DEU,25143.934
Australia,AUS,8,7,2,17,1972,Munich,DEU,69667.086
Greece,GRC,0,2,0,2,1972,Munich,DEU,35764.102
Bulgaria,BGR,6,10,5,21,1972,Munich,DEU,
Switzerland,CHE,0,3,0,3,1972,Munich,DEU,55913.069
Canada,CAN,0,2,3,5,1972,Munich,DEU,119639.463
India,IND,0,0,1,1,1972,Munich,DEU,169179.026
Colombia,COL,0,1,2,3,1972,Munich,DEU,
Belgium,BEL,0,2,0,2,1972,Munich,DEU,44552.011
Japan,JPN,13,8,8,29,1972,Munich,DEU,424630.55
Mongolia,MNG,0,1,0,1,1972,Munich,DEU,
Lebanon,LBN,0,1,0,1,1972,Munich,DEU,
Iran,IRN,0,2,1,3,1972,Munich,DEU,
North Korea,PRK,1,1,3,5,1972,Munich,DEU,
Ethiopia,ETH,0,0,2,2,1972,Munich,DEU,
Tunisia,TUN,0,1,0,1,1972,Munich,DEU,
Argentina,ARG,0,1,0,1,1972,Munich,DEU,
Poland,POL,7,5,9,21,1972,Munich,DEU,
United Kingdom,GBR,4,5,9,18,1972,Munich,DEU,238046.267
Austria,AUT,0,1,2,3,1972,Munich,DEU,34904.601
Germany,DEU,13,11,16,40,1972,Munich,DEU,369740.5
Spain,ESP,0,0,1,1,1972,Munich,DEU,117546.194
Netherlands,NLD,3,1,1,5,1972,Munich,DEU,67347.664
Cuba,CUB,3,1,4,8,1972,Munich,DEU,
Czech Republic,CZE,2,4,2,8,1972,Munich,DEU,
Hungary,HUN,6,13,16,35,1972,Munich,DEU,
Kenya,KEN,2,3,4,9,1972,Munich,DEU,
New Zealand,NZL,1,1,1,3,1972,Munich,DEU,13729.266
Nigeria,NGA,0,0,1,1,1972,Munich,DEU,
Bulgaria,BGR,6,9,7,22,1976,Montreal,CAN,
Canada,CAN,0,5,6,11,1976,Montreal,CAN,187951.588
Romania,ROU,4,9,14,27,1976,Montreal,CAN,
South Korea,KOR,1,1,4,6,1976,Montreal,CAN,51197.085
Trinidad and Tobago,TTO,1,0,0,1,1976,Montreal,CAN,
Germany,DEU,10,12,17,39,1976,Montreal,CAN,538940.87
Netherlands,NLD,0,2,3,5,1976,Montreal,CAN,103280.265
Jamaica,JAM,1,1,0,2,1976,Montreal,CAN,
Thailand,THA,0,0,1,1,1976,Montreal,CAN,
Austria,AUT,0,0,1,1,1976,Montreal,CAN,52552.426
Iran,IRN,0,1,1,2,1976,Montreal,CAN,
Mongolia,MNG,0,1,0,1,1976,Montreal,CAN,
United States,USA,34,35,25,94,1976,Montreal,CAN,1873412
Finland,FIN,4,2,0,6,1976,Montreal,CAN,28098.137
United Kingdom,GBR,3,5,5,13,1976,Montreal,CAN,332293.854
Russia,RUS,49,41,35,125,1976,Montreal,CAN,
Japan,JPN,9,6,10,25,1976,Montreal,CAN,643714.092
Germany,DEU,40,25,25,90,1976,Montreal,CAN,538940.87
North Korea,PRK,1,1,0,2,1976,Montreal,CAN,
Sweden,SWE,4,1,0,5,1976,Montreal,CAN,65651.664
New Zealand,NZL,2,1,1,4,1976,Montreal,CAN,20369.938
Belgium,BEL,0,3,3,6,1976,Montreal,CAN,68068.838
Italy,ITA,2,7,4,13,1976,Montreal,CAN,354559.402
Bermuda,BMU,0,0,1,1,1976,Montreal,CAN,
Denmark,DNK,1,0,2,3,1976,Montreal,CAN,34966.278
Puerto Rico,PRI,0,0,1,1,1976,Montreal,CAN,
Brazil,BRA,0,0,2,2,1976,Montreal,CAN,
Pakistan,PAK,0,0,1,1,1976,Montreal,CAN,
Venezuela,VEN,0,1,0,1,1976,Montreal,CAN,
Poland,POL,7,6,13,26,1976,Montreal,CAN,
Yugoslavia,YUG,2,3,3,8,1976,Montreal,CAN,
Mexico,MEX,1,0,1,2,1976,Montreal,CAN,195611.88
Australia,AUS,0,1,4,5,1976,Montreal,CAN,104079.405
Hungary,HUN,4,5,13,22,1976,Montreal,CAN,
Czech Republic,CZE,2,2,4,8,1976,Montreal,CAN,
Portugal,PRT,0,2,0,2,1976,Montreal,CAN,35123.603
France,FRA,2,3,4,9,1976,Montreal,CAN,350844.298
Cuba,CUB,6,4,3,13,1976,Montreal,CAN,
Spain,ESP,0,2,0,2,1976,Montreal,CAN,184211.01
Norway,NOR,1,1,0,2,1976,Montreal,CAN,25382.781
Switzerland,CHE,1,1,2,4,1976,Montreal,CAN,70824.285
Venezuela,VEN,0,1,0,1,1980,Moscow,RUS,
Jamaica,JAM,0,0,3,3,1980,Moscow,RUS,
Bulgaria,BGR,8,16,17,41,1980,Moscow,RUS,
Russia,RUS,80,69,46,195,1980,Moscow,RUS,
India,IND,1,0,0,1,1980,Moscow,RUS,400332.653
Brazil,BRA,2,0,2,4,1980,Moscow,RUS,
Italy,ITA,8,3,4,15,1980,Moscow,RUS,552301.133
Spain,ESP,1,3,2,6,1980,Moscow,RUS,263827.978
Netherlands,NLD,0,1,2,3,1980,Moscow,RUS,152317.305
Uganda,UGA,0,1,0,1,1980,Moscow,RUS,
Belgium,BEL,1,0,0,1,1980,Moscow,RUS,101107.507
Cuba,CUB,8,7,5,20,1980,Moscow,RUS,
Switzerland,CHE,2,0,0,2,1980,Moscow,RUS,104833.186
Poland,POL,3,14,15,32,1980,Moscow,RUS,
Sweden,SWE,3,3,6,12,1980,Moscow,RUS,93187.363
Romania,ROU,6,6,13,25,1980,Moscow,RUS,
Ireland,IRL,0,1,1,2,1980,Moscow,RUS,22409.778
Zimbabwe,ZWE,1,0,0,1,1980,Moscow,RUS,
United Kingdom,GBR,5,7,9,21,1980,Moscow,RUS,484057.29
Tanzania,TZA,0,2,0,2,1980,Moscow,RUS,
France,FRA,6,5,3,14,1980,Moscow,RUS,532935.642
Mexico,MEX,0,1,3,4,1980,Moscow,RUS,347662.92
Hungary,HUN,7,10,15,32,1980,Moscow,RUS,
Germany,DEU,47,37,42,126,1980,Moscow,RUS,813434.564
Ethiopia,ETH,2,0,2,4,1980,Moscow,RUS,
Czech Republic,CZE,2,3,9,14,1980,Moscow,RUS,
Finland,FIN,3,1,4,8,1980,Moscow,RUS,43930.08
North Korea,PRK,0,3,2,5,1980,Moscow,RUS,
Greece,GRC,1,0,2,3,1980,Moscow,RUS,83957.603
Yugoslavia,YUG,2,3,4,9,1980,Moscow,RUS,
Denmark,DNK,2,1,2,5,1980,Moscow,RUS,50526.186
Mongolia,MNG,0,2,2,4,1980,Moscow,RUS,
Guyana,GUY,0,0,1,1,1980,Moscow,RUS,
Austria,AUT,1,2,1,4,1980,Moscow,RUS,79284.374
Australia,AUS,2,2,5,9,1980,Moscow,RUS,154714.29
Lebanon,LBN,0,0,1,1,1980,Moscow,RUS,
Kenya,KEN,1,0,2,3,1984,Los Angeles,USA,
Morocco,MAR,2,0,0,2,1984,Los Angeles,USA,
Dominican Republic,DOM,0,0,1,1,1984,Los Angeles,USA,
Turkey,TUR,0,0,3,3,1984,Los Angeles,USA,277295.985
Syria,SYR,0,1,0,1,1984,Los Angeles,USA,
Colombia,COL,0,1,0,1,1984,Los Angeles,USA,83008.015
China,CHN,15,8,9,32,1984,Los Angeles,USA,557434.947
Yugoslavia,YUG,7,4,7,18,1984,Los Angeles,USA,
Puerto Rico,PRI,0,1,1,2,1984,Los Angeles,USA,
Romania,ROU,20,16,17,53,1984,Los Angeles,USA,
Netherlands,NLD,5,2,6,13,1984,Los Angeles,USA,196463.943
Chinese Taipei,TPE,0,0,1,1,1984,Los Angeles,USA,
Japan,JPN,10,8,14,32,1984,Los Angeles,USA,1501037.357
Switzerland,CHE,0,4,4,8,1984,Los Angeles,USA,136361.18
Egypt,EGY,0,1,0,1,1984,Los Angeles,USA,
South Korea,KOR,6,6,7,19,1984,Los Angeles,USA,166844.324
Venezuela,VEN,0,0,3,3,1984,Los Angeles,USA,
Nigeria,NGA,0,1,1,2,1984,Los Angeles,USA,
Denmark,DNK,0,3,3,6,1984,Los Angeles,USA,69592.53
Austria,AUT,1,1,1,3,1984,Los Angeles,USA,104119.538
Spain,ESP,1,2,2,5,1984,Los Angeles,USA,345784.114
Portugal,PRT,1,0,2,3,1984,Los Angeles,USA,71952.93
Greece,GRC,0,1,1,2,1984,Los Angeles,USA,103186.985
New Zealand,NZL,8,1,2,11,1984,Los Angeles,USA,40034.179
Brazil,BRA,1,5,2,8,1984,Los Angeles,USA,
Iceland,ISL,0,0,1,1,1984,Los Angeles,USA,3845.445
Zambia,ZMB,0,0,1,1,1984,Los Angeles,USA,
Canada,CAN,10,18,16,44,1984,Los Angeles,USA,390501.086
Sweden,SWE,2,11,6,19,1984,Los Angeles,USA,125968.558
Germany,DEU,17,19,23,59,1984,Los Angeles,USA,1064486.011
Ireland,IRL,0,1,0,1,1984,Los Angeles,USA,30851.409
Cameroon,CMR,0,0,1,1,1984,Los Angeles,USA,
Norway,NOR,0,1,2,3,1984,Los Angeles,USA,56532.699
Belgium,BEL,1,1,2,4,1984,Los Angeles,USA,130453.59
Pakistan,PAK,1,0,0,1,1984,Los Angeles,USA,
Ivory Coast,CIV,0,1,0,1,1984,Los Angeles,USA,
France,FRA,5,7,16,28,1984,Los Angeles,USA,710063.913
Peru,PER,0,1,0,1,1984,Los Angeles,USA,
Algeria,DZA,0,0,2,2,1984,Los Angeles,USA,
Italy,ITA,14,6,12,32,1984,Los Angeles,USA,730858.933
Australia,AUS,4,8,12,24,1984,Los Angeles,USA,211307.195
Mexico,MEX,2,3,1,6,1984,Los Angeles,USA,465959.073
Jamaica,JAM,0,1,2,3,1984,Los Angeles,USA,
United Kingdom,GBR,5,11,21,37,1984,Los Angeles,USA,653312.635
Finland,FIN,4,2,6,12,1984,Los Angeles,USA,61133.087
United States,USA,83,61,30,174,1984,Los Angeles,USA,4037613
Thailand,THA,0,1,0,1,1984,Los Angeles,USA,
Mongolia,MNG,0,0,1,1,1988,Seoul,KOR,
Senegal,SEN,0,1,0,1,1988,Seoul,KOR,
Czech Republic,CZE,3,3,2,8,1988,Seoul,KOR,
U.S. Virgin Islands,VIR,0,1,0,1,1988,Seoul,KOR,
Colombia,COL,0,0,1,1,1988,Seoul,KOR,111458.759
New Zealand,NZL,3,2,8,13,1988,Seoul,KOR,45948.52
Poland,POL,2,5,9,16,1988,Seoul,KOR,
Netherlands,NLD,2,2,5,9,1988,Seoul,KOR,243853.563
Costa Rica,CRI,0,1,0,1,1988,Seoul,KOR,
Philippines,PHL,0,0,1,1,1988,Seoul,KOR,
Turkey,TUR,1,1,0,2,1988,Seoul,KOR,386102.488
France,FRA,6,4,6,16,1988,Seoul,KOR,885681.871
Norway,NOR,2,3,0,5,1988,Seoul,KOR,70349.952
Finland,FIN,1,1,2,4,1988,Seoul,KOR,79142.893
Romania,ROU,7,11,6,24,1988,Seoul,KOR,
Brazil,BRA,1,2,3,6,1988,Seoul,KOR,
Belgium,BEL,0,0,2,2,1988,Seoul,KOR,161512.644
Mexico,MEX,0,0,2,2,1988,Seoul,KOR,530653.793
Peru,PER,0,1,0,1,1988,Seoul,KOR,
Australia,AUS,3,6,5,14,1988,Seoul,KOR,282358.294
Bulgaria,BGR,10,12,13,35,1988,Seoul,KOR,
Pakistan,PAK,0,0,1,1,1988,Seoul,KOR,
Austria,AUT,1,0,0,1,1988,Seoul,KOR,127618.385
Netherlands Antilles,ANT,0,1,0,1,1988,Seoul,KOR,
Denmark,DNK,2,1,1,4,1988,Seoul,KOR,84975.149
United States,USA,36,31,27,94,1988,Seoul,KOR,5236438
Chile,CHL,0,1,0,1,1988,Seoul,KOR,50494.26
China,CHN,5,11,12,28,1988,Seoul,KOR,955150.422
Thailand,THA,0,0,1,1,1988,Seoul,KOR,
Switzerland,CHE,0,2,2,4,1988,Seoul,KOR,168670.151
Italy,ITA,6,4,4,14,1988,Seoul,KOR,927681.412
Germany,DEU,11,14,15,40,1988,Seoul,KOR,1308145.382
Spain,ESP,1,1,2,4,1988,Seoul,KOR,452423.433
Greece,GRC,0,0,1,1,1988,Seoul,KOR,121000.321
Argentina,ARG,0,1,1,2,1988,Seoul,KOR,
Indonesia,IDN,0,1,0,1,1988,Seoul,KOR,
Jamaica,JAM,0,2,0,2,1988,Seoul,KOR,
Japan,JPN,4,3,7,14,1988,Seoul,KOR,2037908.958
Germany,DEU,37,35,30,102,1988,Seoul,KOR,1308145.382
South Korea,KOR,12,10,11,33,1988,Seoul,KOR,282304.362
Yugoslavia,YUG,3,4,5,12,1988,Seoul,KOR,
United Kingdom,GBR,5,10,9,24,1988,Seoul,KOR,873178.007
Sweden,SWE,0,4,7,11,1988,Seoul,KOR,156394.93
Morocco,MAR,1,0,2,3,1988,Seoul,KOR,
Canada,CAN,3,2,5,10,1988,Seoul,KOR,506833.394
Russia,RUS,55,31,46,132,1988,Seoul,KOR,
Djibouti,DJI,0,0,1,1,1988,Seoul,KOR,
Portugal,PRT,1,0,0,1,1988,Seoul,KOR,98348.662
Hungary,HUN,11,6,6,23,1988,Seoul,KOR,
Kenya,KEN,5,2,2,9,1988,Seoul,KOR,
Iran,IRN,0,1,0,1,1988,Seoul,KOR,
Suriname,SUR,1,0,0,1,1988,Seoul,KOR,
Romania,ROU,4,6,8,18,1992,Barcelona,ESP,
South Korea,KOR,12,5,12,29,1992,Barcelona,ESP,445419.836
Mexico,MEX,0,1,0,1,1992,Barcelona,ESP,715277.773
South Africa,ZAF,0,2,0,2,1992,Barcelona,ESP,242020.314
Estonia,EST,1,0,1,2,1992,Barcelona,ESP,
Germany,DEU,33,21,28,82,1992,Barcelona,ESP,1747028.659
Greece,GRC,2,0,0,2,1992,Barcelona,ESP,148649.263
Latvia,LVA,0,2,1,3,1992,Barcelona,ESP,
Ghana,GHA,0,0,1,1,1992,Barcelona,ESP,
Morocco,MAR,1,1,1,3,1992,Barcelona,ESP,
Denmark,DNK,1,1,4,6,1992,Barcelona,ESP,102273.607
Finland,FIN,1,2,2,5,1992,Barcelona,ESP,86867.373
Mongolia,MNG,0,0,2,2,1992,Barcelona,ESP,
Australia,AUS,7,9,11,27,1992,Barcelona,ESP,333745.071
Suriname,SUR,0,0,1,1,1992,Barcelona,ESP,
Thailand,THA,0,0,1,1,1992,Barcelona,ESP,
France,FRA,8,5,16,29,1992,Barcelona,ESP,1113194.79
Ethiopia,ETH,1,0,2,3,1992,Barcelona,ESP,
Puerto Rico,PRI,0,0,1,1,1992,Barcelona,ESP,
Netherlands,NLD,2,6,7,15,1992,Barcelona,ESP,315075.312
Hungary,HUN,11,12,7,30,1992,Barcelona,ESP,85416.346
Switzerland,CHE,1,0,0,1,1992,Barcelona,ESP,199847.877
Kenya,KEN,2,4,2,8,1992,Barcelona,ESP,
Austria,AUT,0,2,0,2,1992,Barcelona,ESP,166545.677
Cuba,CUB,14,6,11,31,1992,Barcelona,ESP,
Turkey,TUR,2,2,2,6,1992,Barcelona,ESP,515680.562
Poland,POL,3,6,10,19,1992,Barcelona,ESP,237275.803
Czech Republic,CZE,4,2,1,7,1992,Barcelona,ESP,122725.773
Namibia,NAM,0,2,0,2,1992,Barcelona,ESP,
Lithuania,LTU,1,0,1,2,1992,Barcelona,ESP,
Malaysia,MYS,0,0,1,1,1992,Barcelona,ESP,
Slovenia,SVN,0,0,2,2,1992,Barcelona,ESP,22471.827
Croatia,HRV,0,1,2,3,1992,Barcelona,ESP,
China,CHN,16,22,16,54,1992,Barcelona,ESP,1471840.436
United States,USA,37,34,37,108,1992,Barcelona,ESP,6520327
Spain,ESP,13,7,2,22,1992,Barcelona,ESP,580716.596
Japan,JPN,3,8,11,22,1992,Barcelona,ESP,2664920.015
Colombia,COL,0,0,1,1,1992,Barcelona,ESP,187881.644
Unified Team,EUN,45,38,29,112,1992,Barcelona,ESP,
Argentina,ARG,0,0,1,1,1992,Barcelona,ESP,
New Zealand,NZL,1,4,5,10,1992,Barcelona,ESP,52664.59
Indonesia,IDN,2,2,1,5,1992,Barcelona,ESP,
Belgium,BEL,0,1,2,3,1992,Barcelona,ESP,203147.02
Italy,ITA,6,5,8,19,1992,Barcelona,ESP,1141667.537
Chinese Taipei,TPE,0,1,0,1,1992,Barcelona,ESP,
Israel,ISR,0,1,1,2,1992,Barcelona,ESP,86994.815
Pakistan,PAK,0,0,1,1,1992,Barcelona,ESP,
Peru,PER,0,1,0,1,1992,Barcelona,ESP,
Individual Olympic Athletes,IOA,0,1,2,3,1992,Barcelona,ESP,
Bulgaria,BGR,3,7,6,16,1992,Barcelona,ESP,
Nigeria,NGA,0,3,1,4,1992,Barcelona,ESP,
Norway,NOR,2,4,1,7,1992,Barcelona,ESP,88185.988
Brazil,BRA,2,1,0,3,1992,Barcelona,ESP,
United Kingdom,GBR,5,3,12,20,1992,Barcelona,ESP,1021273.532
North Korea,PRK,4,0,5,9,1992,Barcelona,ESP,
Canada,CAN,7,4,7,18,1992,Barcelona,ESP,584998.762
Sweden,SWE,1,7,4,12,1992,Barcelona,ESP,180173.615
Iran,IRN,0,1,2,3,1992,Barcelona,ESP,
Algeria,DZA,1,0,1,2,1992,Barcelona,ESP,
Bahamas,BHS,0,0,1,1,1992,Barcelona,ESP,
Qatar,QAT,0,0,1,1,1992,Barcelona,ESP,
Ireland,IRL,1,1,0,2,1992,Barcelona,ESP,53659.393
Jamaica,JAM,0,3,1,4,1992,Barcelona,ESP,
Philippines,PHL,0,0,1,1,1992,Barcelona,ESP,
Azerbaijan,AZE,0,1,0,1,1996,Atlanta,USA,
Australia,AUS,9,9,23,41,1996,Atlanta,USA,423181.512
India,IND,0,0,1,1,1996,Atlanta,USA,1639800.406
Germany,DEU,20,18,27,65,1996,Atlanta,USA,1967539.568
Turkey,TUR,4,1,1,6,1996,Atlanta,USA,655568.734
Greece,GRC,4,4,0,8,1996,Atlanta,USA,170909.839
Denmark,DNK,4,1,1,6,1996,Atlanta,USA,124645.348
Brazil,BRA,3,3,9,15,1996,Atlanta,USA,1364355.991
Burundi,BDI,1,0,0,1,1996,Atlanta,USA,
Syria,SYR,1,0,0,1,1996,Atlanta,USA,
Georgia,GEO,0,0,2,2,1996,Atlanta,USA,
United States,USA,44,32,25,101,1996,Atlanta,USA,8073122
Czech Republic,CZE,4,3,4,11,1996,Atlanta,USA,151155.623
Ecuador,ECU,1,0,0,1,1996,Atlanta,USA,
Thailand,THA,1,0,1,2,1996,Atlanta,USA,
Argentina,ARG,0,2,1,3,1996,Atlanta,USA,
Bulgaria,BGR,3,7,5,15,1996,Atlanta,USA,57134.671
Ireland,IRL,3,0,1,4,1996,Atlanta,USA,74317.043
China,CHN,16,22,12,50,1996,Atlanta,USA,2511946.979
Tonga,TON,0,1,0,1,1996,Atlanta,USA,
Cuba,CUB,9,8,8,25,1996,Atlanta,USA,
Israel,ISR,0,0,1,1,1996,Atlanta,USA,118493.2
Finland,FIN,1,2,1,4,1996,Atlanta,USA,102688.609
Armenia,ARM,1,1,0,2,1996,Atlanta,USA,
Indonesia,IDN,1,1,2,4,1996,Atlanta,USA,1175514.685
Trinidad and Tobago,TTO,0,0,2,2,1996,Atlanta,USA,
France,FRA,15,7,15,37,1996,Atlanta,USA,1273114.085
Italy,ITA,13,10,12,35,1996,Atlanta,USA,1307915.738
Algeria,DZA,2,0,1,3,1996,Atlanta,USA,
Ethiopia,ETH,2,0,1,3,1996,Atlanta,USA,
United Kingdom,GBR,1,8,6,15,1996,Atlanta,USA,1269581.66
Sweden,SWE,2,4,2,8,1996,Atlanta,USA,211081.101
Iran,IRN,1,1,1,3,1996,Atlanta,USA,
Chinese Taipei,TPE,0,1,0,1,1996,Atlanta,USA,
Canada,CAN,3,11,8,22,1996,Atlanta,USA,711888.548
Costa Rica,CRI,1,0,0,1,1996,Atlanta,USA,24699.364
Zambia,ZMB,0,1,0,1,1996,Atlanta,USA,
Uzbekistan,UZB,0,1,1,2,1996,Atlanta,USA,
Uganda,UGA,0,0,1,1,1996,Atlanta,USA,
Belarus,BLR,1,6,8,15,1996,Atlanta,USA,
Hong Kong,HKG,1,0,0,1,1996,Atlanta,USA,161682.748
Jamaica,JAM,1,3,2,6,1996,Atlanta,USA,
Slovakia,SVK,1,1,1,3,1996,Atlanta,USA,50425.483
Morocco,MAR,0,0,2,2,1996,Atlanta,USA,
Kenya,KEN,1,4,3,8,1996,Atlanta,USA,
Namibia,NAM,0,2,0,2,1996,Atlanta,USA,
Spain,ESP,5,6,6,17,1996,Atlanta,USA,675655.944
New Zealand,NZL,3,2,1,6,1996,Atlanta,USA,68906.83
Serbia and Montenegro,SCG,1,1,2,4,1996,Atlanta,USA,
Romania,ROU,4,7,9,20,1996,Atlanta,USA,129638.012
Malaysia,MYS,0,1,1,2,1996,Atlanta,USA,
Lithuania,LTU,0,0,1,1,1996,Atlanta,USA,22941.763
Puerto Rico,PRI,0,0,1,1,1996,Atlanta,USA,
Norway,NOR,2,2,3,7,1996,Atlanta,USA,117243.382
Poland,POL,7,5,5,17,1996,Atlanta,USA,318949.455
South Korea,KOR,7,15,5,27,1996,Atlanta,USA,668716.335
Mexico,MEX,0,0,1,1,1996,Atlanta,USA,845410.685
South Africa,ZAF,3,1,1,5,1996,Atlanta,USA,295554.385
Mozambique,MOZ,0,0,1,1,1996,Atlanta,USA,
Moldova,MDA,0,1,1,2,1996,Atlanta,USA,
Portugal,PRT,1,0,1,2,1996,Atlanta,USA,149801.613
Ukraine,UKR,9,2,12,23,1996,Atlanta,USA,
Hungary,HUN,7,4,10,21,1996,Atlanta,USA,96196.504
Tunisia,TUN,0,0,1,1,1996,Atlanta,USA,
Bahamas,BHS,0,1,0,1,1996,Atlanta,USA,
Belgium,BEL,2,2,2,6,1996,Atlanta,USA,230441.688
Switzerland,CHE,4,3,0,7,1996,Atlanta,USA,222517.356
Austria,AUT,0,1,2,3,1996,Atlanta,USA,194997.651
Kazakhstan,KAZ,3,4,4,11,1996,Atlanta,USA,
Croatia,HRV,1,1,0,2,1996,Atlanta,USA,39758.817
Japan,JPN,3,6,5,14,1996,Atlanta,USA,3140144.839
Nigeria,NGA,2,1,3,6,1996,Atlanta,USA,
Mongolia,MNG,0,0,1,1,1996,Atlanta,USA,
Philippines,PHL,0,1,0,1,1996,Atlanta,USA,
Slovenia,SVN,0,2,0,2,1996,Atlanta,USA,28383.946
Latvia,LVA,0,1,0,1,1996,Atlanta,USA,14224.128
Russia,RUS,26,21,16,63,1996,Atlanta,USA,877181.595
North Korea,PRK,2,1,2,5,1996,Atlanta,USA,
Netherlands,NLD,4,5,10,19,1996,Atlanta,USA,379802.241
Ireland,IRL,0,1,0,1,2000,Sydney,AUS,114987.727
Algeria,DZA,1,1,3,5,2000,Sydney,AUS,
Jamaica,JAM,0,6,3,9,2000,Sydney,AUS,
Qatar,QAT,0,0,1,1,2000,Sydney,AUS,
Spain,ESP,3,3,5,11,2000,Sydney,AUS,876008.108
Iran,IRN,3,0,1,4,2000,Sydney,AUS,
Sweden,SWE,4,5,3,12,2000,Sydney,AUS,262890.9
Hungary,HUN,8,6,3,17,2000,Sydney,AUS,121085.109
Indonesia,IDN,1,3,2,6,2000,Sydney,AUS,1097928.464
Japan,JPN,5,8,5,18,2000,Sydney,AUS,3460607.15
Armenia,ARM,0,0,1,1,2000,Sydney,AUS,
India,IND,0,0,1,1,2000,Sydney,AUS,2184672.996
Australia,AUS,16,25,17,58,2000,Sydney,AUS,537613.644
Kazakhstan,KAZ,3,4,0,7,2000,Sydney,AUS,
Iceland,ISL,0,0,1,1,2000,Sydney,AUS,8377.672
Israel,ISR,0,0,1,1,2000,Sydney,AUS,157214.843
Argentina,ARG,0,2,2,4,2000,Sydney,AUS,
Italy,ITA,13,8,13,34,2000,Sydney,AUS,1542231.344
France,FRA,13,14,11,38,2000,Sydney,AUS,1589936.939
South Korea,KOR,8,10,10,28,2000,Sydney,AUS,871501.091
Portugal,PRT,0,0,2,2,2000,Sydney,AUS,194323.464
Latvia,LVA,1,1,1,3,2000,Sydney,AUS,19019.264
Poland,POL,6,5,3,14,2000,Sydney,AUS,408478.391
Nigeria,NGA,1,2,0,3,2000,Sydney,AUS,
Georgia,GEO,0,0,6,6,2000,Sydney,AUS,
Lithuania,LTU,2,0,3,5,2000,Sydney,AUS,29569.579
Azerbaijan,AZE,2,0,1,3,2000,Sydney,AUS,
Thailand,THA,1,0,2,3,2000,Sydney,AUS,
Greece,GRC,4,6,3,13,2000,Sydney,AUS,210979.958
Macedonia,MKD,0,0,1,1,2000,Sydney,AUS,12471.199
Bahamas,BHS,2,0,1,3,2000,Sydney,AUS,
South Africa,ZAF,0,2,3,5,2000,Sydney,AUS,346921.747
Finland,FIN,2,1,1,4,2000,Sydney,AUS,138703.58
Trinidad and Tobago,TTO,0,1,1,2,2000,Sydney,AUS,
Kyrgyzstan,KGZ,0,0,1,1,2000,Sydney,AUS,
Romania,ROU,11,6,9,26,2000,Sydney,AUS,131305.899
Kuwait,KWT,0,0,1,1,2000,Sydney,AUS,
Sri Lanka,LKA,0,1,0,1,2000,Sydney,AUS,
Switzerland,CHE,1,6,2,9,2000,Sydney,AUS,264299.171
Germany,DEU,13,17,26,56,2000,Sydney,AUS,2237046.164
Kenya,KEN,2,3,2,7,2000,Sydney,AUS,
North Korea,PRK,0,1,3,4,2000,Sydney,AUS,
Colombia,COL,1,0,0,1,2000,Sydney,AUS,262804.16
New Zealand,NZL,1,0,3,4,2000,Sydney,AUS,82996.391
Canada,CAN,3,3,8,14,2000,Sydney,AUS,901029.605
Saudi Arabia,SAU,0,1,1,2,2000,Sydney,AUS,824128.264
Chinese Taipei,TPE,0,1,4,5,2000,Sydney,AUS,
Chile,CHL,0,0,1,1,2000,Sydney,AUS,146574.192
China,CHN,28,16,14,58,2000,Sydney,AUS,3687630.036
Morocco,MAR,0,1,4,5,2000,Sydney,AUS,
Mozambique,MOZ,1,0,0,1,2000,Sydney,AUS,
Estonia,EST,1,0,2,3,2000,Sydney,AUS,13184.477
Belarus,BLR,3,3,11,17,2000,Sydney,AUS,
Slovenia,SVN,2,0,0,2,2000,Sydney,AUS,35818.652
Moldova,MDA,0,1,1,2,2000,Sydney,AUS,
Belgium,BEL,0,2,3,5,2000,Sydney,AUS,284950.464
Vietnam,VNM,0,1,0,1,2000,Sydney,AUS,
Brazil,BRA,0,6,6,12,2000,Sydney,AUS,1583737.988
Russia,RUS,32,28,29,89,2000,Sydney,AUS,1073593.408
Ukraine,UKR,3,10,10,23,2000,Sydney,AUS,
United States,USA,37,24,32,93,2000,Sydney,AUS,10252347
Croatia,HRV,1,0,1,2,2000,Sydney,AUS,47307.968
Austria,AUT,2,1,0,3,2000,Sydney,AUS,235450.19
Mexico,MEX,1,2,3,6,2000,Sydney,AUS,1096780.846
Uruguay,URY,0,1,0,1,2000,Sydney,AUS,
Uzbekistan,UZB,1,1,2,4,2000,Sydney,AUS,
Barbados,BRB,0,0,1,1,2000,Sydney,AUS,
Costa Rica,CRI,0,0,2,2,2000,Sydney,AUS,32084.564
Slovakia,SVK,1,3,1,5,2000,Sydney,AUS,61331.765
Norway,NOR,4,3,3,10,2000,Sydney,AUS,165952.701
Denmark,DNK,2,3,1,6,2000,Sydney,AUS,153089.947
Bulgaria,BGR,5,6,2,13,2000,Sydney,AUS,52491.528
Czech Republic,CZE,2,3,3,8,2000,Sydney,AUS,166568.303
Cuba,CUB,11,11,7,29,2000,Sydney,AUS,
Ethiopia,ETH,4,1,3,8,2000,Sydney,AUS,
Cameroon,CMR,1,0,0,1,2000,Sydney,AUS,
Netherlands,NLD,12,9,4,25,2000,Sydney,AUS,507779.885
United Kingdom,GBR,11,10,7,28,2000,Sydney,AUS,1556000.788
Serbia and Montenegro,SCG,1,1,1,3,2000,Sydney,AUS,
Turkey,TUR,3,0,2,5,2000,Sydney,AUS,609198.924
Greece,GRC,6,6,4,16,2004,Athens,GRC,278691.884
Trinidad and Tobago,TTO,0,0,1,1,2004,Athens,GRC,
Switzerland,CHE,1,1,3,5,2004,Athens,GRC,297823.895
Israel,ISR,1,0,1,2,2004,Athens,GRC,171959.472
Iran,IRN,2,2,2,6,2004,Athens,GRC,
Jamaica,JAM,2,1,2,5,2004,Athens,GRC,
Spain,ESP,3,11,6,20,2004,Athens,GRC,1121204.316
Hong Kong,HKG,0,1,0,1,2004,Athens,GRC,234155.559
Indonesia,IDN,1,1,2,4,2004,Athens,GRC,1421001.335
Japan,JPN,16,9,12,37,2004,Athens,GRC,3940077.56
India,IND,0,1,0,1,2004,Athens,GRC,3004720.147
Zimbabwe,ZWE,1,1,1,3,2004,Athens,GRC,
Kazakhstan,KAZ,1,4,3,8,2004,Athens,GRC,
Hungary,HUN,8,6,3,17,2004,Athens,GRC,164041.614
Dominican Republic,DOM,1,0,0,1,2004,Athens,GRC,
Sweden,SWE,4,2,1,7,2004,Athens,GRC,304256.148
Netherlands,NLD,4,9,9,22,2004,Athens,GRC,582563.82
Colombia,COL,0,0,2,2,2004,Athens,GRC,325554.521
Serbia and Montenegro,SCG,0,2,0,2,2004,Athens,GRC,
Slovakia,SVK,2,2,2,6,2004,Athens,GRC,81732.325
China,CHN,32,17,14,63,2004,Athens,GRC,5736266.277
Eritrea,ERI,0,0,1,1,2004,Athens,GRC,
Egypt,EGY,1,1,3,5,2004,Athens,GRC,
Mongolia,MNG,0,0,1,1,2004,Athens,GRC,
Chinese Taipei,TPE,2,2,1,5,2004,Athens,GRC,
New Zealand,NZL,3,2,0,5,2004,Athens,GRC,102514.645
United Arab Emirates,ARE,1,0,0,1,2004,Athens,GRC,
Cuba,CUB,9,7,11,27,2004,Athens,GRC,
Croatia,HRV,1,2,2,5,2004,Athens,GRC,62559.614
Denmark,DNK,2,1,5,8,2004,Athens,GRC,177870.417
Morocco,MAR,2,1,0,3,2004,Athens,GRC,
Turkey,TUR,3,3,4,10,2004,Athens,GRC,735155.229
Ukraine,UKR,8,5,9,22,2004,Athens,GRC,
Czech Republic,CZE,1,3,5,9,2004,Athens,GRC,213269.646
Estonia,EST,0,1,2,3,2004,Athens,GRC,19787.615
Slovenia,SVN,0,1,3,4,2004,Athens,GRC,45416.216
Kenya,KEN,1,4,2,7,2004,Athens,GRC,
Syria,SYR,0,0,1,1,2004,Athens,GRC,
North Korea,PRK,0,4,1,5,2004,Athens,GRC,
Argentina,ARG,2,0,4,6,2004,Athens,GRC,470169.433
Norway,NOR,5,0,1,6,2004,Athens,GRC,195223.614
Portugal,PRT,0,2,1,3,2004,Athens,GRC,224984.02
Cameroon,CMR,1,0,0,1,2004,Athens,GRC,
Belarus,BLR,2,5,6,13,2004,Athens,GRC,
Paraguay,PRY,0,1,0,1,2004,Athens,GRC,
Bahamas,BHS,1,0,1,2,2004,Athens,GRC,
Romania,ROU,8,5,6,19,2004,Athens,GRC,192696.972
Uzbekistan,UZB,2,1,2,5,2004,Athens,GRC,
Nigeria,NGA,0,0,2,2,2004,Athens,GRC,
Russia,RUS,28,26,36,90,2004,Athens,GRC,1582506.988
Bulgaria,BGR,2,1,9,12,2004,Athens,GRC,70947.276
Poland,POL,3,2,5,10,2004,Athens,GRC,509450.66
South Korea,KOR,9,12,9,30,2004,Athens,GRC,1142611.13
United Kingdom,GBR,9,9,12,30,2004,Athens,GRC,1913771.614
Azerbaijan,AZE,1,0,4,5,2004,Athens,GRC,
Canada,CAN,3,6,3,12,2004,Athens,GRC,1083146.524
Venezuela,VEN,0,0,2,2,2004,Athens,GRC,
Latvia,LVA,0,4,0,4,2004,Athens,GRC,27699.88
Austria,AUT,2,4,1,7,2004,Athens,GRC,275769.77
Germany,DEU,13,16,20,49,2004,Athens,GRC,2583409.013
Georgia,GEO,2,2,0,4,2004,Athens,GRC,
Lithuania,LTU,1,2,0,3,2004,Athens,GRC,43968.09
France,FRA,11,9,13,33,2004,Athens,GRC,1820723.319
South Africa,ZAF,1,3,2,6,2004,Athens,GRC,431832.392
Chile,CHL,2,0,1,3,2004,Athens,GRC,189179.005
Thailand,THA,3,1,4,8,2004,Athens,GRC,
Ethiopia,ETH,2,3,2,7,2004,Athens,GRC,
Brazil,BRA,5,2,3,10,2004,Athens,GRC,1922011.09
United States,USA,36,39,26,101,2004,Athens,GRC,12213730
Belgium,BEL,1,0,2,3,2004,Athens,GRC,333856.905
Australia,AUS,17,16,17,50,2004,Athens,GRC,675038.955
Finland,FIN,0,2,0,2,2004,Athens,GRC,162992.94
Mexico,MEX,0,3,1,4,2004,Athens,GRC,1263142.485
Italy,ITA,10,11,11,32,2004,Athens,GRC,1703460.096
France,FRA,7,16,20,43,2008,Beijing,CHN,2259255.844
Jamaica,JAM,5,4,2,11,2008,Beijing,CHN,
Egypt,EGY,0,0,2,2,2008,Beijing,CHN,
Estonia,EST,1,1,0,2,2008,Beijing,CHN,30525.864
Ethiopia,ETH,4,2,1,7,2008,Beijing,CHN,
Italy,ITA,8,9,10,27,2008,Beijing,CHN,2089717.307
Israel,ISR,0,0,1,1,2008,Beijing,CHN,200719.741
Finland,FIN,1,1,2,4,2008,Beijing,CHN,212980.742
Japan,JPN,9,8,8,25,2008,Beijing,CHN,4517267.524
Iceland,ISL,0,1,0,1,2008,Beijing,CHN,13879.916
Iran,IRN,1,0,1,2,2008,Beijing,CHN,
Indonesia,IDN,1,1,4,6,2008,Beijing,CHN,1986656.18
Georgia,GEO,3,2,2,7,2008,Beijing,CHN,
Germany,DEU,16,11,14,41,2008,Beijing,CHN,3103958.247
Greece,GRC,0,2,1,3,2008,Beijing,CHN,341817.829
India,IND,1,0,2,3,2008,Beijing,CHN,4339909.661
Ecuador,ECU,0,1,0,1,2008,Beijing,CHN,
Ireland,IRL,0,1,2,3,2008,Beijing,CHN,198299.13
Cameroon,CMR,1,0,0,1,2008,Beijing,CHN,
Canada,CAN,3,9,8,20,2008,Beijing,CHN,1342396.613
Morocco,MAR,0,1,1,2,2008,Beijing,CHN,188405.513
Armenia,ARM,0,1,4,5,2008,Beijing,CHN,
Dominican Republic,DOM,1,1,0,2,2008,Beijing,CHN,
Austria,AUT,0,1,2,3,2008,Beijing,CHN,343812.976
Azerbaijan,AZE,1,1,4,6,2008,Beijing,CHN,
North Korea,PRK,2,2,2,6,2008,Beijing,CHN,
Bulgaria,BGR,1,1,3,5,2008,Beijing,CHN,107410.912
Algeria,DZA,0,1,1,2,2008,Beijing,CHN,
Brazil,BRA,3,4,10,17,2008,Beijing,CHN,2556454.782
Netherlands,NLD,7,5,4,16,2008,Beijing,CHN,763407.575
Australia,AUS,14,15,17,46,2008,Beijing,CHN,851983.13
Argentina,ARG,2,0,4,6,2008,Beijing,CHN,697557.859
Bahamas,BHS,0,1,1,2,2008,Beijing,CHN,
Portugal,PRT,1,1,0,2,2008,Beijing,CHN,281542.549
Belgium,BEL,2,0,0,2,2008,Beijing,CHN,405729.43
Nigeria,NGA,0,3,2,5,2008,Beijing,CHN,
Panama,PAN,1,0,0,1,2008,Beijing,CHN,
New Zealand,NZL,3,2,4,9,2008,Beijing,CHN,127057.687
Norway,NOR,3,5,1,9,2008,Beijing,CHN,294277.831
Poland,POL,4,5,2,11,2008,Beijing,CHN,697829.214
Belarus,BLR,3,4,7,14,2008,Beijing,CHN,
Malaysia,MYS,0,1,0,1,2008,Beijing,CHN,
Mongolia,MNG,2,2,0,4,2008,Beijing,CHN,
Latvia,LVA,1,1,1,3,2008,Beijing,CHN,42500.525
Moldova,MDA,0,0,1,1,2008,Beijing,CHN,
Sudan,SDN,0,1,0,1,2008,Beijing,CHN,
Singapore,SGP,0,1,0,1,2008,Beijing,CHN,327263.784
Uzbekistan,UZB,0,1,3,4,2008,Beijing,CHN,
Venezuela,VEN,0,0,1,1,2008,Beijing,CHN,
Thailand,THA,2,2,2,6,2008,Beijing,CHN,
Togo,TGO,0,0,1,1,2008,Beijing,CHN,
Slovakia,SVK,3,3,0,6,2008,Beijing,CHN,127626.827
Slovenia,SVN,1,2,2,5,2008,Beijing,CHN,59839.586
Tajikistan,TJK,0,1,1,2,2008,Beijing,CHN,
Trinidad and Tobago,TTO,1,1,0,2,2008,Beijing,CHN,
United Kingdom,GBR,19,13,19,51,2008,Beijing,CHN,2264898.174
United States,USA,36,39,37,112,2008,Beijing,CHN,14712845
Vietnam,VNM,0,1,0,1,2008,Beijing,CHN,
Samoa,WSM,0,1,0,1,2008,Beijing,CHN,
Ukraine,UKR,7,4,11,22,2008,Beijing,CHN,
Sweden,SWE,0,4,1,5,2008,Beijing,CHN,388684.19
Spain,ESP,5,11,3,19,2008,Beijing,CHN,1528583.756
Serbia,SRB,0,1,2,3,2008,Beijing,CHN,
Switzerland,CHE,2,1,4,7,2008,Beijing,CHN,413714.827
Romania,ROU,4,1,4,9,2008,Beijing,CHN,344669.95
Tunisia,TUN,1,0,0,1,2008,Beijing,CHN,
Turkey,TUR,1,1,3,5,2008,Beijing,CHN,1139548.435
South Korea,KOR,13,11,8,32,2008,Beijing,CHN,1468996.086
China,CHN,48,22,30,100,2008,Beijing,CHN,10033233.9
Chinese Taipei,TPE,1,1,2,4,2008,Beijing,CHN,
Mexico,MEX,2,0,2,4,2008,Beijing,CHN,1653898.19
Mauritius,MUS,0,0,1,1,2008,Beijing,CHN,
Hungary,HUN,3,5,2,10,2008,Beijing,CHN,207757.652
Croatia,HRV,0,2,3,5,2008,Beijing,CHN,89507.429
Kazakhstan,KAZ,2,3,4,9,2008,Beijing,CHN,
Lithuania,LTU,0,3,2,5,2008,Beijing,CHN,66270.653
Chile,CHL,0,1,0,1,2008,Beijing,CHN,275716.447
Cuba,CUB,3,10,17,30,2008,Beijing,CHN,
Kyrgyzstan,KGZ,0,1,2,3,2008,Beijing,CHN,
South Africa,ZAF,0,1,0,1,2008,Beijing,CHN,580492.268
Russia,RUS,24,13,23,60,2008,Beijing,CHN,3091455.591
Afghanistan,AFG,0,0,1,1,2008,Beijing,CHN,
Colombia,COL,0,2,1,3,2008,Beijing,CHN,445994.474
Denmark,DNK,2,2,3,7,2008,Beijing,CHN,226767.494
Czech Republic,CZE,3,3,1,7,2008,Beijing,CHN,290503.947
Kenya,KEN,6,4,6,16,2008,Beijing,CHN,
Zimbabwe,ZWE,1,3,0,4,2008,Beijing,CHN,
Lithuania,LTU,2,0,3,5,2012,London,GBR,73809.042
Latvia,LVA,1,0,1,2,2012,London,GBR,43549.741
Kuwait,KWT,0,0,1,1,2012,London,GBR,
Netherlands,NLD,6,6,8,20,2012,London,GBR,792041.828
Kenya,KEN,2,4,7,13,2012,London,GBR,
South Korea,KOR,13,9,8,30,2012,London,GBR,1684562.928
Serbia,SRB,1,1,2,4,2012,London,GBR,
New Zealand,NZL,6,2,5,13,2012,London,GBR,145417.047
Saudi Arabia,SAU,0,0,1,1,2012,London,GBR,1672470.749
Japan,JPN,7,14,17,38,2012,London,GBR,4799612.88
Slovakia,SVK,0,1,3,4,2012,London,GBR,145826.897
Singapore,SGP,0,0,2,2,2012,London,GBR,435967.947
Spain,ESP,4,10,4,18,2012,London,GBR,1483646.902
Russia,RUS,20,20,27,67,2012,London,GBR,3480301.72
Germany,DEU,11,20,13,44,2012,London,GBR,3487234.448
Qatar,QAT,0,0,2,2,2012,London,GBR,
Grenada,GRD,1,0,0,1,2012,London,GBR,
Kazakhstan,KAZ,3,1,7,11,2012,London,GBR,
Jamaica,JAM,4,5,3,12,2012,London,GBR,
Ireland,IRL,1,1,4,6,2012,London,GBR,213240.963
Guatemala,GTM,0,1,0,1,2012,London,GBR,
Egypt,EGY,0,3,1,4,2012,London,GBR,
Hong Kong,HKG,0,0,1,1,2012,London,GBR,373485.399
Norway,NOR,2,1,1,4,2012,London,GBR,327987.716
Romania,ROU,2,4,1,7,2012,London,GBR,378485.712
Hungary,HUN,8,4,6,18,2012,London,GBR,230214.451
Puerto Rico,PRI,0,1,1,2,2012,London,GBR,
Poland,POL,3,2,6,11,2012,London,GBR,903836.561
Iran,IRN,7,5,1,13,2012,London,GBR,
Portugal,PRT,0,1,0,1,2012,London,GBR,277991.759
Indonesia,IDN,0,2,1,3,2012,London,GBR,2413435.226
Sweden,SWE,1,4,3,8,2012,London,GBR,432488.303
India,IND,0,2,4,6,2012,London,GBR,6153155.414
Mongolia,MNG,0,2,3,5,2012,London,GBR,
Italy,ITA,8,9,11,28,2012,London,GBR,2172383.108
North Korea,PRK,4,0,2,6,2012,London,GBR,
Mexico,MEX,1,3,4,8,2012,London,GBR,2012767.781
Slovenia,SVN,1,1,2,4,2012,London,GBR,59745.667
Montenegro,MNE,0,1,0,1,2012,London,GBR,
Morocco,MAR,0,0,1,1,2012,London,GBR,225677.095
Malaysia,MYS,0,1,1,2,2012,London,GBR,
Azerbaijan,AZE,2,2,5,9,2012,London,GBR,
South Africa,ZAF,4,1,1,6,2012,London,GBR,637033.795
Uzbekistan,UZB,0,0,3,3,2012,London,GBR,
Vietnam,VNM,0,0,1,1,2012,London,GBR,
Switzerland,CHE,2,2,0,4,2012,London,GBR,479280.805
Greece,GRC,0,0,2,2,2012,London,GBR,275155.48
Afghanistan,AFG,0,0,1,1,2012,London,GBR,
Algeria,DZA,1,0,0,1,2012,London,GBR,
Tajikistan,TJK,0,0,1,1,2012,London,GBR,
Denmark,DNK,2,4,3,9,2012,London,GBR,250524.599
Argentina,ARG,1,1,2,4,2012,London,GBR,819697.902
Venezuela,VEN,1,0,0,1,2012,London,GBR,
Gabon,GAB,0,1,0,1,2012,London,GBR,
Thailand,THA,0,2,2,4,2012,London,GBR,
Armenia,ARM,0,1,1,2,2012,London,GBR,
Finland,FIN,0,2,1,3,2012,London,GBR,221285.636
Cameroon,CMR,0,0,1,1,2012,London,GBR,
Estonia,EST,0,1,1,2,2012,London,GBR,34642.164
Ethiopia,ETH,3,2,3,8,2012,London,GBR,
Australia,AUS,8,15,12,35,2012,London,GBR,997527.347
Trinidad and Tobago,TTO,1,1,2,4,2012,London,GBR,
France,FRA,11,11,13,35,2012,London,GBR,2474005.287
Dominican Republic,DOM,1,1,0,2,2012,London,GBR,
Georgia,GEO,1,2,3,6,2012,London,GBR,
United Kingdom,GBR,29,17,19,65,2012,London,GBR,2439691.339
Tunisia,TUN,2,0,1,3,2012,London,GBR,
Bahamas,BHS,1,0,0,1,2012,London,GBR,
Cyprus,CYP,0,1,0,1,2012,London,GBR,27503.333
Turkey,TUR,1,1,1,3,2012,London,GBR,1550688.484
Cuba,CUB,5,3,7,15,2012,London,GBR,
Bahrain,BHR,1,0,0,1,2012,London,GBR,
United States,USA,46,28,30,104,2012,London,GBR,16197007
Croatia,HRV,3,1,2,6,2012,London,GBR,90338.799
Uganda,UGA,1,0,0,1,2012,London,GBR,
Czech Republic,CZE,4,3,4,11,2012,London,GBR,307490.199
Colombia,COL,1,3,5,9,2012,London,GBR,548251.361
Belarus,BLR,2,5,3,10,2012,London,GBR,
Bulgaria,BGR,0,2,1,3,2012,London,GBR,118701.781
Brazil,BRA,3,5,9,17,2012,London,GBR,2998534.425
China,CHN,38,31,22,91,2012,London,GBR,15124539.5
Canada,CAN,2,5,11,18,2012,London,GBR,1468094.965
Chinese Taipei,TPE,1,0,1,2,2012,London,GBR,
Ukraine,UKR,5,4,10,19,2012,London,GBR,
Belgium,BEL,0,1,2,3,2012,London,GBR,469720.336
Botswana,BWA,0,1,0,1,2012,London,GBR,
Hungary,HUN,8,3,4,15,2016,Rio de Janeiro,BRA,273925.72
Jamaica,JAM,6,3,2,11,2016,Rio de Janeiro,BRA,
Spain,ESP,7,4,6,17,2016,Rio de Janeiro,BRA,1733213.64
Slovakia,SVK,2,2,0,4,2016,Rio de Janeiro,BRA,161074.014
France,FRA,10,18,14,42,2016,Rio de Janeiro,BRA,2864105.631
Greece,GRC,3,1,2,6,2016,Rio de Janeiro,BRA,296029.545
Switzerland,CHE,3,2,2,7,2016,Rio de Janeiro,BRA,570267.342
Germany,DEU,17,10,15,42,2016,Rio de Janeiro,BRA,4165169.905
Georgia,GEO,2,1,4,7,2016,Rio de Janeiro,BRA,
India,IND,0,1,1,2,2016,Rio de Janeiro,BRA,7665672.881
Tajikistan,TJK,1,0,0,1,2016,Rio de Janeiro,BRA,
Sweden,SWE,2,6,3,11,2016,Rio de Janeiro,BRA,500423.665
Individual Olympic Athletes,IOA,1,0,1,2,2016,Rio de Janeiro,BRA,
Indonesia,IDN,1,2,0,3,2016,Rio de Janeiro,BRA,2744896.64
Trinidad and Tobago,TTO,0,0,1,1,2016,Rio de Janeiro,BRA,
Finland,FIN,0,0,1,1,2016,Rio de Janeiro,BRA,246928.493
Iran,IRN,3,1,4,8,2016,Rio de Janeiro,BRA,
Qatar,QAT,0,1,0,1,2016,Rio de Janeiro,BRA,
Mexico,MEX,0,3,2,5,2016,Rio de Janeiro,BRA,2383253.082
Tunisia,TUN,0,0,3,3,2016,Rio de Janeiro,BRA,
Slovenia,SVN,1,2,1,4,2016,Rio de Janeiro,BRA,70079.359
Thailand,THA,2,2,2,6,2016,Rio de Janeiro,BRA,
Dominican Republic,DOM,0,0,1,1,2016,Rio de Janeiro,BRA,
Japan,JPN,12,8,21,41,2016,Rio de Janeiro,BRA,5158900.414
Jordan,JOR,1,0,0,1,2016,Rio de Janeiro,BRA,
Denmark,DNK,2,6,7,15,2016,Rio de Janeiro,BRA,297719.06
Kazakhstan,KAZ,3,5,10,18,2016,Rio de Janeiro,BRA,
Czech Republic,CZE,1,2,7,10,2016,Rio de Janeiro,BRA,381420.335
South Korea,KOR,9,3,9,21,2016,Rio de Janeiro,BRA,2026967.822
Kenya,KEN,6,6,1,13,2016,Rio de Janeiro,BRA,
Turkey,TUR,1,3,4,8,2016,Rio de Janeiro,BRA,2116398.303
Kosovo,XKX,1,0,0,1,2016,Rio de Janeiro,BRA,
Egypt,EGY,0,0,3,3,2016,Rio de Janeiro,BRA,
Croatia,HRV,5,3,2,10,2016,Rio de Janeiro,BRA,103842.682
Lithuania,LTU,0,1,3,4,2016,Rio de Janeiro,BRA,88700.479
Colombia,COL,3,2,3,8,2016,Rio de Janeiro,BRA,665398.39
South Africa,ZAF,2,6,2,10,2016,Rio de Janeiro,BRA,707743.902
Chinese Taipei,TPE,1,0,2,3,2016,Rio de Janeiro,BRA,
Malaysia,MYS,0,4,1,5,2016,Rio de Janeiro,BRA,
United Arab Emirates,ARE,0,0,1,1,2016,Rio de Janeiro,BRA,
China,CHN,26,18,26,70,2016,Rio de Janeiro,BRA,18712097.15
Ireland,IRL,0,2,0,2,2016,Rio de Janeiro,BRA,339999.931
Norway,NOR,0,0,4,4,2016,Rio de Janeiro,BRA,308522.085
Ethiopia,ETH,1,2,5,8,2016,Rio de Janeiro,BRA,
Nigeria,NGA,0,0,1,1,2016,Rio de Janeiro,BRA,
Australia,AUS,8,11,10,29,2016,Rio de Janeiro,BRA,1215297.461
Netherlands,NLD,8,7,4,19,2016,Rio de Janeiro,BRA,890488.555
Serbia,SRB,2,4,2,8,2016,Rio de Janeiro,BRA,
North Korea,PRK,2,3,2,7,2016,Rio de Janeiro,BRA,
Morocco,MAR,0,0,1,1,2016,Rio de Janeiro,BRA,252196.888
Mongolia,MNG,0,1,1,2,2016,Rio de Janeiro,BRA,
Argentina,ARG,3,1,0,4,2016,Rio de Janeiro,BRA,885227.529
Azerbaijan,AZE,1,7,10,18,2016,Rio de Janeiro,BRA,
Poland,POL,2,3,6,11,2016,Rio de Janeiro,BRA,1075392.661
Brazil,BRA,7,6,6,19,2016,Rio de Janeiro,BRA,2939094.21
Singapore,SGP,1,0,0,1,2016,Rio de Janeiro,BRA,501247.434
Burundi,BDI,0,1,0,1,2016,Rio de Janeiro,BRA,
Algeria,DZA,0,2,0,2,2016,Rio de Janeiro,BRA,
Portugal,PRT,0,0,1,1,2016,Rio de Janeiro,BRA,326364.379
Bulgaria,BGR,0,1,2,3,2016,Rio de Janeiro,BRA,142696.411
United Kingdom,GBR,27,23,17,67,2016,Rio de Janeiro,BRA,2896753.121
Cuba,CUB,5,2,4,11,2016,Rio de Janeiro,BRA,
Puerto Rico,PRI,1,0,0,1,2016,Rio de Janeiro,BRA,
Fiji,FJI,1,0,0,1,2016,Rio de Janeiro,BRA,
Uzbekistan,UZB,4,2,7,13,2016,Rio de Janeiro,BRA,
Venezuela,VEN,0,2,1,3,2016,Rio de Janeiro,BRA,
Israel,ISR,0,0,2,2,2016,Rio de Janeiro,BRA,322994.484
Estonia,EST,0,0,1,1,2016,Rio de Janeiro,BRA,41548.815
Italy,ITA,8,12,8,28,2016,Rio de Janeiro,BRA,2420672.141
Ivory Coast,CIV,1,0,1,2,2016,Rio de Janeiro,BRA,
Canada,CAN,4,3,15,22,2016,Rio de Janeiro,BRA,1678093.396
Grenada,GRD,0,1,0,1,2016,Rio de Janeiro,BRA,
Niger,NER,0,1,0,1,2016,Rio de Janeiro,BRA,
Belgium,BEL,2,2,2,6,2016,Rio de Janeiro,BRA,550677.566
Russia,RUS,19,17,20,56,2016,Rio de Janeiro,BRA,3538975.3
Austria,AUT,0,0,1,1,2016,Rio de Janeiro,BRA,460282.647
Belarus,BLR,1,4,4,9,2016,Rio de Janeiro,BRA,
Vietnam,VNM,1,1,0,2,2016,Rio de Janeiro,BRA,
Romania,ROU,1,1,2,4,2016,Rio de Janeiro,BRA,478201.584
United States,USA,46,37,38,121,2016,Rio de Janeiro,BRA,18745075
Bahrain,BHR,1,1,0,2,2016,Rio de Janeiro,BRA,
New Zealand,NZL,4,9,5,18,2016,Rio de Janeiro,BRA,188355.645
Bahamas,BHS,1,0,1,2,2016,Rio de Janeiro,BRA,
Philippines,PHL,0,1,0,1,2016,Rio de Janeiro,BRA,
Armenia,ARM,1,3,0,4,2016,Rio de Janeiro,BRA,
Ukraine,UKR,2,5,4,11,2016,Rio de Janeiro,BRA,
